Followers:

William Stoller: williamtstoller
John Bulmer: _johnbulmer_
Elias Castillon: eliascastillon1
SpecialNeeds Family: specialneeds_family
Nicholas Reynolds: nicholasrey76
Madison Livingston: madison_livingston4422
Madeline Magee: mads_magee
Kiwi Corrigan: kiwi.corrigan
Erin Sherman: erinsherm11
Anna Byrnes: anna._.byrnes
Lauren: laurenbattagliaa
Heston: hit_man_dios
Joshua Lamb: joshualamb9
roni: ronibardugo
Matt: matthew_kaighan36
Andi Shapan: andi.shapan
Finley Florianic: florianicfinley
Megan: meganmyers00
Nick Raymond: nick_raymond_
Kebi Doan: wh0s.k3b1
Ainsley Mullins: theaterkid4_
MK Miller: mkmiller173
Peta Herson Silansky: eventsbypeta
Alexandra Chloupek: alexandra_chloupek
Vivien Perryman: vivien6296747
Janie McWhirter Irwin: janie_irwin
Maddie Simmons: maddiesimmons3
Stacey Segal: segalstacey
Ava :): avaaidala
Betty Black: betty_shellblack
Ethan Korpinen: ethan.korpinen
William Chloupek: w_chloupek
Jenah Ramji: jenah_ramji26
Christina Cook: _cmc_5
***FrogsBeautiful***: lydia_sup_
M e g a n R y l a n d: megan_ryland
Rayna: rayna_abedi
Yael_yrs: yaelsarembock
makena: makena.rose.13
Ronak Patel: ronakdpatel4
Coin Pets: danacoin
Julian Delorme: julian_delorme_
John: johnneilson24
Gayla Artman: gjartman
catherine: thecatherine08
Alex Segal: alexandrasegallsu
Xavier Kunovich: xavierkunovich
kat :): kathrynnn_joy
britney: britneywhite28_
Rees Gunnerson: reesgunnerson_
Kathy M: kathy__texas
Oliviarhett: oliviarhettt
ellie goodno: elliegoodno
Sloan Barber: sloanbarber_
Jack Mullins: kinglil3000
Jankruger3: jankruger32786
Ben Rodriguez: ben_rodriguez3
Andrea Delorme: andrea_delorme_
: efie.maguire
Jack Sisk (sisko): 1siskoo
Russell Mitts: ccggtf4
Mamma Mia Pizza: mammamiapizzashelton
Hayden Goodiel: hayden_goodiel_7
Ashton Abbott: abbott.ashton
Ford Myers: fit_boi_ferd
Charlie King: charcharistheman
ELLA: ellaacohenn_
Mark White: markwhitetexas
Jennifer: jford7557
Luciana Palermo: lupcoelhop
evelyn wilfong: evelyn.wilfong
Chris: chris.gabriel_
DeLana R Ethridge: delanamullins78
Luke: luke___010
Noah: noaho632
Ella Trev: ellatrevino37
Avery Macha: a_r_m2007
rachel sarah hunt: rachelhunt_o5
Peyton David Owen: chillpikachu_12
Liza Collins: lizadenton
Kate_white: kate_white234
Jen Rickard: realjenrickard
AddyG: addygamp
Maisie Doerr: a_doerr_able
Deborah Woods: deborahiwoods
Parker Crumrine: parker.crumrine
Hero Fraser: hero_e_fraser
Tammy Atchison Eggen: grammytammys
Jack Glass: jack_glass_
Laura Sandel Gilbreath: l.gilbreath.5
Cambre: cambrecm
Sharon Walker Johnston: mysharonaj
Betsy Stephenson: betsymcglynnstephenson
Andrew Henderson: andrewhenderson__
Christi Hampton: grams.of.4
Santina Shanay Traylor: _mstraylor
Quinn Muccio: quinnmuccio
Shelly Johnson Lloyd: shelly_llo
Laura Nomenclature: lauranomenclature
Max Boul: _themadpug_
Josie: josephine.artist
Kara Prescott: karahprescott
Cooper: cooper__k3
Brady Foster: bmoneyy0
Bill Callis: billcallis
Alex Malakoff: alexmalakoff
Kimberly Fox Stokes: stokesmomma
Dylan Howard: dylanhoward7
Brendan Mack: brendan__mack
Vincent L.: 10_vineyard_2023
Mayra Cabrera: mcabrera4487
Amanda Liese: amanda_liese
Marlow Books: series_hard_pronounce_letters
The Good Life Park Cities Mag: thegoodlifeparkcitiesmagazine
Tripp Moss: rgm3moss
Sarah Mathis: sarahmathis_49
peyton frady: peytonfradyy
Alden Brosseau: alden_bross
Kendall Bernbaum: kendallbernbaum
Arman Daddy: armoon_glizzzy
Alex Page: alexpage5656
Sarah567: ssolomons2244
runahalf: runahalf13.1
Lindsay Eden Feldman: feldmama
: jaketaber11
Julie Lewis Crozier: julielewiscrozier
Darcy Preheim: darcypreheim54
Brooke: brooke.earlyyyy
GrantGhali: grantghali
Gray Goldman: gray_goldman
Beatrix: beatrix_sidney
Jo Ann Miller: jo.a.miller.56
Mary Jane Neilson: mjneilson
Meridith Patterson Hayes: merihayes
Catherine Abbott: kitcat_abbott05
Maggie: maggie.tipton
suds!!: sutton_rockman
Michelle Fallon: me_fallon
catclay: catclay
Elizabeth Patterson: bubbles9327
Bella Blackwell: crazybellaboo18
Christy Thomas: christythomas9418
Sayf: sayfhawa
Hortencia Delorme: chachychachi
John S. Wilson: stackman14
Caeden Wood: caeden.wood
Blythe: libertygirl_11
Learning Ally Volunteers: volunteernation_learningally
Matthew Preheim: jeff649964
E W: elizapwilson
Jackie: jackiejs_swisher
Bo Little: bo.little
Anthony Marchetti: anthony_marchetti13
Teresa Schneider: teresa6565
Kelli Primavera: mamakellip
Carlos Davis: carlosdavis477
Eleise Beth: eleisebeth
Michelle Moquin Dye: micdye
Sign Dreamers DallasParkCities: signdreamersdallasparkcities
Shannon S.: shannonspainhour1
Reesa Moore: rmoore0708
Lauren: lauren.e.ladd
Caitie: cjaymurphy
Bennett Wright: bennettwright32
KYLIE: kyliegingold
PHOEBE: phoebe.rupp
Ethan Proctor: ethan_proctor11111
Sydney Carter: sydjcarter
Candace Swango: candaceswango
John_Bulmer: tazmanianwaffle
Doug Feick: dpfeick
Elisha Brandenberger: ebrandenberger
: nicodavis2021
K A T E B A T I E: katebatie
Korbin: korbin_hines
Jennifer Harriman: electricangel15
Matthewhallam: matthewhalehallam
Etan Cohn: etan_cohn
ira: iramvbb
Lisa Rassi: lisa_rassi
Lara Harrison: larawh
Beth: blangemcd
Creation Station Dance - ND: creationstationnorthdallas
Tami Peacock: tami_peacock
Sulayne Wright: snicklefritz0269
Zayd shaheed: its_____zayd
Matthew: matthewhbrd
Matthewstrawman: mstrawman55
Nancy Berry Shores: nshores
Sophia Dye: dye.sophia
Diana Liese: diana.liese
Holly DeWaay Ramundt: hramundt
Your Mother: jem_tx5636
Nathan: n1than___
lily Attmore: lgattmore
Julia Knowles: julia__knowles
Alex: afrank10
Alicia Horvath: aliciahorvath
Jack Wilson: jswjr20
Alexander: alexander_arens_
Shelley Amason: shelley_amason
Whit Stansbury: whitstansbury
Levi: levi_gwin
: claudiaqguzman
Kimberly Rader Ball: kimrball
Caroline Brantman: caroline_and__avellinoz
Carrie Rosamond: carrie.rosamond
Laura Pendleton: laura.k.pendleton
Fay Michaelis: fairldy_
Ann S Woodbury: annswoodbury_official
Stephen Niran Oladejo: bbq_africa
Michaela’s tARTs: michaelaslemontarts
Don Mccabe: sixmac
Heather Schamerloh: hschame
Travis Wood: doow_sivart
Jennie Warthan Jones: jennie_warthan_jones
Michael Lagattuta: mike_lags76
Allison Stuckey: al_stuck
Mary Laidlaw Hefner: mrs_hef
AVERY VIRACOLA: aves_cheer
Aubrey Adair: adairaubrey
Danielle Arens: danielle_arens_
: lara1treeh
Leah Generale: leahgenerale
Penny Apollaro: pennyapollaro
Heather Schwartz Shapan: hshapan
Emmykaighan: emmykaighan
Marisa Purdy Stockwood: marisapurdystockwood
alex: alexandrovett
Jack B: jack_bendalin26
Paige Glazer: pkglazer
Linda Lipson Pitt Beltzman: unquagirl
Megan Kennaugh: kennaughmegan
Jason Makler: jmakler73
Kaylee Moore: kblove0811
Angela Horowitz: angelahorowitz
Maddie Givens: maddie_givens
beez!: beeziecrosland
Daniel Bulmer: daniel_bulmer12
Desiree Fetters: desifetters
Kelly Haydon Love: dallaskel21
Amy Bradley Dodson: mellymerda
LINDS: llindsaykaplan
Jennerdeblank: jennerdeblank
Kesler Woolley: keslerwoolley
Chana R. Yavner!: chanarivkayavner
Ben Gordon: ben.gordon_
Andrea O Norman: andiold
Jackie Sneathern: jackiesneathern
.p.s.: payton_s_14
Garnett Holmes: garnettholmes
Laine Jones: llainejones
Ian Cruz: ian_cruz28
Susan Shosid Bendalin: susanbendi
Jessica, Dyslexia Therapist: drivenbydyslexia
meremathews: meremathews
Julio Villarruel: julio_villarruel213
Drew Clark: drewclark_21
Jordan Weidenbaker: jordy_drummer
Jack tallent: jack_tallent11
Sy Black: syblack9678
Kathryn Wells: ktaylorwells
Keith McCook: keithmccook
Grayson: gr.ayson104
Madeline Prescott: madeline.prescott
DreWel: drewel5
Melissa Ramos Mason: melissaramos82
Kim S: jandimom
Sara: sarabwhite00
Kristi Lukeman Owens: kristiowens
Caroline Wilson: caroline.22
Karen Dwyer: karen_dwy
Dbiesman: daveybiesman
Kevin Frady: dkfrady
Beth Henton: bethhenton
: tatumtuthill
Heather Endicott: hrich777
Ashley Rasmussen: ashleyrasmussen297
Fatima Omerovic Smailovic: fatimaomerovicsmailovic
hannah: hannahtuthill23
Laura Shadden: laura_shadden
Christy Fowler: bballfanchristy
Lori Pinson Rodriguez: lorirod23
Elizabeth Feille Cannon: elizabeth_f_cannon
Luckey McDowell: luckeymcdowell
Joshua Prescott: josh._.drummer
Dalton Davis: dalt0ndavis
Heidi Kelly: heidiboo71
Karen Riddle Wakefield: karen_wakefield03
Brooke Peterson: bstrangep
Tracy Gardner Aaron: tracyaaron
Jennifer Whitaker: jennifersue
Mica Hopkins: micaphopkins
Harry Pratt: harrypratt24
thedallasportal: thedallasportal
Travis Houstoun: houstoun5
Hunter Michaelis: _.h.u.n.ter
Lillia: lillia_71
Rae: e.v.baybee
Joann St Pe: joannstpe
Andy Clark: clarkgolf70
Anne Pierce: annepierce65
Karringtyn: karringtyn_keen
Kelly Wilson: mrskellybwilson
Diego: diegoc1305
Patrick Corwin: patrick.corwin_ftw
Adrienne Murphy: murphy_4545
Richard Goree: richardglifestyle
: tac317
Geoff Crumrine: geoffcrumrine
jesi: jesiroberts_
Drew Ashmore: _drew.ash_
risahunt: risahunt
Julia: julia.genovese
Celine Sirinoglu: celine_mcd
Will Housh: hsuohlliw
Donna Tanner: donnartanner
Karen McClard: drkaren
Chris: chrisdelcore7
Paula Joseph Crumrine: pjcrumrine
Garrett: garrettj.55
Tessa Brollier Moss: tessabmoss
Kristin Blaylock: kjbh2o
Sharon Kraft: skkraft
Sydney Stewart: sydneystewart19
Michele Pokorny: michelepoko
Taylor-Ann McKenzie: taylor_ann.mckenzie
John Myers: johnmyers.2
Molly Johnsey Hayes: molly150
Ty Wieters ™: _tywieters_
Sammie Johnston: johnstonsammie
Matthew: mblaylockdallas
Hayden Becker: haydenbk3
Torri Sanger Cruz: tcruz1989
Strickland: mattstrick_23
Weldon Wright: weldingo5
Melanie Stegman: melstegman
Dawson Swehla: dawsonswehla2
Angela: angelastraface324
Deborah Cuzalina: burndj88
Katarina Freudenthal: kat_freudenthal
Mandy Anderson: mandyandy_bu
Mallory Browning O'Connor: malloryoconnor
Blair Pogue: blairpogue
Bill.Cleary: bill.cleary89
Laura Hull: lauraghull3
Carrie Shillingburg: carrie_shillingburg
Matthew Laza: matthew_laza
Gina O'Donnell: ginarothodonnell
: jedidiahgibson28
Drew Innmon: drewi22
janamc98: janamc98
Max Israelstam: max_israelstam
Denise Smith: hipster_carole
Ella Margiotta: ellamargiotta
Grenda Moss: grendamoss
Sarah Elaine Zubiate: sarahezubiate
: melissatorres
Brendan gura: brendangura
Maria Nikolopoulos: marianikolopoulos
Dan Hanson: thegeez54
Lori Johnson: lojotx
Jack: jackwetherington
Aimee Rodriguez: aimeetol
JudyArch: jyarchbold
Christine Laczai: christinelaczai
Tommy Hughes: talltommy_95
Alysia: writingqueen
Ellery Maxson: ellery_maxson
Rachel Polka: rachpolka
Jaden Pollak: jadenpollak
Rachel Heredia: _grandmarae
Reagan Sterling: reagan.sterling37
Christopher Kollias: kolliac
Melissa Bryant Pogue: melpogue
Rocio Calle: cio62
Isaac: isaace.77
Jane Jackson: janefullerjackson
Ryan Abernathy: ryanabernathy1
Heidi Snadon: hsnadon
Jeannie Matthews: jeannie.matthews.180
Lica Ayres: lica.ayres
Gabriel Imery: gabriel.imery
Brice Weinstein: briceweinstein
Lanier Fisher: lanierfisher
Laker Lee: lee.laker
kristin rees gunnerson: kristinrees
Chuck: charlie_leake
marki :): markitomasides
Luvi Valdez: valdezluvi
Samantha Janelle: sammyj3320
Maddox: rookandmaddox
JG: makejggreatagain
Jennifer Thompson: jthompson2405
Amanda Trevino: a.s.t.visual
Jessica M Hall: jessica.m.hall
Karen Law Bruton: brutonmom
Amy Delaney: ardelaney4
Brooke Haynes: brooke.haynes_
Greg Delagi: rgdelagi
Lisa Newman: lisa.newman.942
Angela Baird Cheves: chevesangela
Meili West: meili_e.west
Maren Doherty: doherty10
Garrett Kembel: garrettkte82
Evelyn: ecostolo
Stephen Holloway: steve_otype1badae
Ashley Foretti: leighleigh1983
E * L O P E Z: ellielopez
ryan kassanoff: ryankassanoff
Kathryn Raymer Proctor: katyproc33
Neeha Patel: neehapatel
Ellie_Smith: ellie_smith46
Brenda De Luna: brendadelunam
Mando L: mandolopez12345
: emargow
Jill Allen Schirru: jillschirru
Janie Robertson Richardson: jrich723
Hazel Koch: hazel_koch_texas
Jenny McClure: jennymcclure3
Anna O'Connor Smith: annaoconnorsmith
Kimberly Haynes: kimhaynes
Reagan Pogue: reaganpogue7370
Aaron Reynolds: aaronareynolds
Tobin Knox: tobinknox
Linda Johnson: johnson6828linda
Tatelyn Alexander: tatelyn_alexander
Josh white: josh_d_white
kailey: kaileylane3
Seth: seth.dauber
Andy Aronson - State Farm: agentandyaronson
Caitlyn G: _caitlyn_groff_
Ryan Wierzbicki: ryanwierzbicki_
Jennifer Kellett Giles: myrefocuscoach
patricia: patriciagallaher10
Lauren Patton: _laurenpatton_
jordan alexandra: downtown.jordanbrown
Alison Garcia: arrg.___
Wil Matthews: wilmatthews_
Stephanie Berry: stephanielberry
Dede Toothaker Wolf: dorothytwolf
Tabitha Valdez: tabi.valdez
Jack Collet: imjackcollet_
Scott Michaelis: scott.michaelis
Madeline Deasy: madelinedeasy
Kerri Woolley: kkwool
Nico Paramo: nico.paramo
Shema Ampolini: shemaamp
Heidi: hfrasna
Sarah: sssworee
Leigh Erin Lundy: leigherinjones
LeticiaRibeiro: leticia.ribeiro26
Blake: blake_fetters21
Keith Conlon: beefconlon
Dana Janes Balzer: danab16
Lene' Alley DeRudder: ognotoriouslad
Darcy Scarborough: darcyscarborough
Peter Dethrow: peterdethrow
Sam Korman: sam.korman.photos
Len Wierzbicki: wierz96
Ally Abbasi: allyabbasi
Michelle Maggio Edmonds: michellemedmonds
Jennifer Eckert: turnbunthurman
Amy Kelton: amykeltoncushner
Wes Kirtland: wes.kirtland
Lauren Magee: lbsooner
Blossom Creative School LLC: blossomcreativeschool
Denise Stewart: denisestewart46
Debbie mccabe: dedbee67
Jack Webster: jack_webster1
Deborah Gibbins: dlgibbins
Max Bensing: _maxbensing
Mellany Braddock Barnett: mlb1212
Caroline: jcfisch_r
maddi seatvet: maddiseatvet
Nikki Durtschi: yellowrosie16
Amanda Ramsey: aramsey04
Karis: karisgross
Jill Jackson Curtis: jmcurtis23
Julie Visconsi: jdvisconsi
: jakeriggs04
patricsanchez: patricsanchez6
Andrew Osborne: _andrew_osborne
Karon Terrell Jones: karon.t.jones
harry gibbins: harry1gibbins
Alexander Chapa: chapipapi
Christine Schmitz Danuser: christinedanuser
Meredith Ladd: lamere
Erik Gunnerson: iamerikgun
Amiya (:: amiya.rayburn
e m m a h u r w i t z: ehurwitz23
Anne Daughety Dethrow: annedethrow
Alisa Lynn Richardson: alisalynnrich
Andrea Wood: answerstomom
Bryan D Bloomfield: _bryandbc01_
: isabellaphan_
Teresa Mantzey: tmantzey
Janet Leon: jleon1011
Henry Hurt: _hentard_
Seth Kassanoff: seth.kassanoff
Kelly Woods: kwoooooods
Nudrah Khan: nudrahkhan
Amie Brunner: amiebrunner
: gracemimi1
Cate Coulter: catecoult
gracelyn nix: gracelyn_nix
ella: ellahoustoun
: benfinetto
Ben: benjaminerickson09_
Haley: haleymo32
Amy: amyb7024
Darlene Burton: darleneburton9924
Mandy Myers Evans: mandyevans214
Josh Gingold: josh_gingold
Carreen Carson: carreencarson
Graysontracy3: graysontracy3
Margaret De Tullio: margaretdetullio
Elizabeth Wallace: ewallacedallas
Ben Stafford: _its_benny_boy
Shreeya Rimal: skhat
Christine Paddock: christinepaddock75
Kenzie: mackbd03
Kristin Jensen Rogers: ker3415
Gavin Cruz: gavin.cruz.3572
Tania Sneider: taniasneider
John Costello: john_costello_ytg
Marcela Gerez: marcegerez_realestate
Erin Hickman: erinehickman
Ben Luedtke: benluedtke
Lauren Darr: lauren.darr
Becca Lange: blange47
Jennifer Willson: jennifer_willson5
Ayelet Elle Nesher-Haviv: ayelet.elle
Tonya Clark: tlclark71
Daniel Brooke: danielbrooke
Karie Hollifield Welsh: karie_welsh5
Jack Riggs: lahotsauce83
Sarah Spencer: sarahbonds007
Margaret Watson Walsh: margaret.j.walsh
Wesley Smith: wesmsmith
Kim Henley: kimhenley1
Kiddie Academy FarNorthDallas: kiddie_academy_north_dallas
Ricki Shoss Ebner: shossebner
Molly: mollyejouvenal
Ava Adkins Reis: ava_reis
Jack Grob: jack.grob
Gabriel Rojas: grojas33
Tuck Boggs: tuck.214
Jamie Black Standifer: thejamiestandifer
Jackson Williams: jhunterwilliams
Sunshine: pansy0414
Bryan Buechler: unknownmuffinman
Kari Shelton Grzych: kgrzych
: kbbrockette
Sef Wright: sef_wright
Linda: lpwins
Q.Haynes: qhaynes2
Kelly: cicconekelly
John Raleigh: jrals21
Ashley Smith Rupp: ashleysrupp
Jamie Gjerde Lashley: jamiers16
Minah Suh: minahsuh
Doug Phillips: dougiephil
Georgana L Jinks: jinkshasclass
Ashley Absalom: ashabs11
Aidan: ai.dan8788
Travis Hensarling: ___travinator___
Jackie: ladyjcharb
: jsudbeck
Christine O'Brien Horstman: chris.horstman
Adrienne Pulliam: adiepulliam
Julie Henderson: julie__henderson
Savannah: savannahbabyjd1
Ashley Stevens Lamb: ashleylambphotography
Jackson Schneider: jacksonschneider16
JEK: jennifer_esping
Madison Paige Dunn: madisonpaigedoula
Mitchell W: mhw_719
Kate Kelley: katesdigitaldoodles
Kristal roberts: kristalrr
Suzanne Burk: suzanneburk
: campbell___b
Karen Laker: karenlaker
Kara Gehan: gehankara
Shannon: shanmcspadden
Sandra Balis: sandrabalis
Claudia: cfuentes_1
Elisabeth Rutledge: lizajanedallas
Zachary Paxton: zpaxton14
Kimberly Williams: kimby79
Corey Redmond Telschow: crtelschow
Chris Cochran: c_jcochran
margaret: margbyrnes
Luke Robinson: lukerobinson62
Chrissy Tomasino: godmom01
Wendi Whitehead Ryland: 4rylandgirls
Gam: graham_cotten
Beth Kirner: kirnerfam
: anthmen
Jenny Galvan: jennyraubgalvan
Khalid Wilford: khalidwilford
Maddie Washburn: madelyn.31
Andy Roberts: andy_bently1
Kendall Marie Cree: kendallmarie
Brad Bruckner: btb0916
Ashton Klongpayabal: ashklongpayabal
Kallie: kallie_galvan
Brittani Frankowiak: brittanifrankowiak
Staci Shapiro Rubin: momoffiverubins
kallie :): kalliecpatterson
Carrie Hopper King: carrieking4444
Santrecia Sharay Mitchell: santreciasharaymitchell
Olivia Morris: olivia._morris
Katie E.: katie_edmisten
Carol Yartym: cyartym
Melanie Holm Young: melyoung00
Danalivni: dana._.liv
Enlightening The Dark Theatre: etdtheatre
Ethan Armour: armour.ethan
Laura Bloom Gordon: lbgordotx
Henry Salewske: henry_salewske
carolinemandel: carolinemandel
Ashton Wyatt: ashtonwyatt94
Nora Twomey: nora_twomey
Kendra Grace: 2sillyboys
Amanda Fair: amandalaurenfair
Anna Carroll: contigo_kidsyoga
Live life fully: jrgmlnoris
Brooke Zasa: byzasa
Kimberly Armour: anyhoo74
Veronica Munoz: ver0mun0z
Shae Galardi: shaegalardi
Lauren Scales: loecouture
Zac Robison: zacrobison88
L & A S H O W R O O M: l_and_a_showroom
Ben Rodrigue: benrodrigue_
Dana Rubin: dana.rubin1
Amber Castelli: gratefulyflawed
Jane Zansler: jzansler
rsue20: rsue20
Kim Marshall Oliver: kimoliver6
Beverly Hall Nedwed: beverlynedwed
Katie Medlin: sassysoutherngirl86
Katie Kruger: katielkruger
Sarah Bennett: bysarahbennett
Marie Baugh Deasy: mariedeasy
Ben Addison: benaddison00
Carla Sousa: carlasousa5
Lauren Newby: laurennewby1
Jacob Eckart: jacob_eckart
Jennifer Ogden: jennsogden
Katie Ebner Goodno: lifeisgoodno
Julie Mitchell: juliannemitchell
Jessica Silverman: jessicasilverman_
Martha Ahearn: marthaahearn
: joey_rousso
Caroline Glazier: caroline_glazee
: ratalamantez
Jill Burns: texasjburns
Brandon Wood: woody010
Patti Parrish Cadigan: tca_patti
Sophia Dorward: tiediepeace
Adi B3ltzman: adibeltz
Mark W. Malcolm: mark.w.malcolm.1
Bridget Campion: bridgetcampion
Whitney Wells Giles: wwggemini
Allison Holliday: aclineholliday
Alexis Dopson: alexisdopson
Shedonna Mark: shedonnadc
Nicole Rackley Sears: nicsears04
Britni Hardage: britni_hardage
Michelle Good Dupré: thedupres99
anilashetty: anilashetty
elysemarie2095: elysemarie2095
Amy Henning: ahenning71
Amber Seale: amberseale16
Eve Myers Herman: eve.herman
Montessori Community School: mcsslc
Stanhope Denegre Jr: stanhopeduce
North Texas Therapy: northtexastherapyandhomecare
Mary Belz: a_mary_ca_
eli: 3li_hines
Aidan Gray Weeks: aidanweeks_15
Jett Harris: 22jettro
Luke Ott: ott.luke
Kerry Douglas: kerry_d3610
Kristin Wertz: kristinwertz
Suzette Switzer: suzetteswitzer
Levi,Richtofen,James D: jamesdavid4095_cosplay
Jessica Slaven: jcslaven
Michael Konradi: mckonradi
Will Killebrew: willebrew1
Mary Mitchell: mpllmitchell
gabbyt71: gabbyt71
m_townsend: m_townsend
Sarah Marks: sgmarksberry
OSS Virgo: oss_virgo
Holly Broome Myers: lhbmyers
Kristin Jarrett: kristin__jarrett
Caroline Farish: caroline_farish
Stephanie Edmisten: stephanieedmisten
Tony Apollaro: apollaro25
Mary Strode Ayres: marysayres
Ms.Sands: mssands1st
JD Zasa: jdz_10
ccooper1802: ccooper1802
Lauren Barnes Garrity: lbgarrity
Carrie Moore: cmoore832
Charles: charlesreeg.04
Barrett Kahle: barrett.kahle
Pauline Guerra: paulineg455
Jenna Hagan: jruthhagan94
bethdelagi: bethdelagi
Rachel Hickman: rachel.hickman
Lori Anderson: sweetksmom
Ryder Weidenbaker: ryderw67
Sam Rubin: the_meme_inspector689
Mary Claire Melton: mcmtwo469
Lauren: mrs.laurenmedina
Sherry Houpt Dallas Artist: sherryhoupt
: ellie.goodwin
Nicki Farris: nvfarris
kiki: angeliki.paulos
Aidan cakar: aidan_caka
Andrea Vitek: rainwatervitek
Susan Viracola: sviracola
Holly Porter Vitullo: holly.vitullo
Brian Sweet: briansweetpress
eobrien1: eobrien1
Ann Wright: a_wright74
Holly Irving: hlirving
Dylan Holliday: dylan.holliday
Betsy Parton Winkler: winklerbetsy
Brooke Simon Horton: brookeahorton
• Zoe - Z •: pony._.jumper
Beverly Hickman: beverlyhickman
M a d e l y n: xmadelyn.mx
Trenton Thompson: trenton_thompson05
Autumn McCoy: autumnpatrice
Kross: kross.wellshear
Miles Kelly: phirstprepster
Estela Villasenor: estelawolfe
Morgan Hendershott: _hendershott
Schaefer_Terstriep: schaef_67
K3: young_kingkk
Justin Farmer: justinfarmer.sothebys
Ms. Lauren | M.S., CCC-SLP: ms.lauren_slp
Anna Cramm: annacramm
Julia Rosenblatt: julia_rosenblatt
Alexandra Dowd: alexandradowd
Randi Burnett: rlburnett
Elizabeth Pulsinelli: elizabethpulsinelli
Joey Newman: covertoperater
Cliff n: cliffrnewby
Laura Whitfield: laurajeanwhit
William R.: insta4will
Yolanda Javier: yazminmj20
Elizabeth Feldman Chapel: elizabethfeldman
Ryan Richardson: rfrichardson
Ryan Pitts: jpitts1
Alyce Kathryn Wood Stewart: akw.stewart
Mary Grace Mewett: marygracemewett
Zach Burnett: zaburnett68
Cristy Cobble Brandenburg: cristyb_1
nolejess: nolejess
Tom Hoefken: tom.hoefken
: patrickjconroy
William Meloncon: the_life_of_moo
: razaandroth
Kristi Hall Stokes: stokeskristi
Brady K: bradyk5308
Isabelle Abad Turner: isabelle_abad
Good Shepherd Student Ministry: gsstudentmin
Leah Leonard: leahl_bellab
Chris Finetto: chrisfinetto
: alexa.galardi
dwhitham: dwhitham
Julianna Smith: julianna_momof4
Courtney Dios: dailydoseof_dios
Page Fielder: pagefielderrealestate
Luke Rasmussen: luke_ras22
Kelly Cooper: kkcoop0317
Lane Hawkins @ Q Sciences: lanehaw
Claudia Kim Leon: claudiakleon
Coach DeBryan Tyson: thecoachdt
Corrie Shores: shorescorrie
Rennie Silverman: rensilver
Lisa Cakar: lisalipsticklover
Kristen Gonzalez: kecatalane
Emily Braden Miller: millergirls
Melissa Swensen Martin: melissa.s.martin.39
Kristin Schellack Cooper: ks_cooper
Jvannuccini: jvannuccini
Shelley Swan: shelleylswan
Sadie Maguire Carter: sadiemagcart
Meghan Chauncy: monstermae93
Cindy Slavin: cindy.slavin
Darla Beam: darla_beam
Lacquer & Brass: lacquerandbrass
rnoris: rnoris
Zoe O. Paul: sage._.montessori
Anthony apollaro sr: tausna69
Felipe Alcala: felipealcala7
The Stoller Family: thestollersix
Amber Rietdijk Carter: amberlcarter
Kyndall Sue: kyndallsue
Amy: hou5toun
Emily A. Moore: emilymoo88
Michelle Snyder: michelle.l.snyder
David O'Connell: djoconnell
Matthew Cole Beasley: mbeasleyrealtor
Natalia Rexach: nataliarexach
Ashley Peron: ashleyperon
: thecolpizzle
Brian: grilldaddybrian
Quinn: qumulater
Luke Fossier: fossierluke
amandatracy4: amandatracy4
Joseph Wolf: wolf4624
Keri Chambers: kerichambers
Michelle Coppolino: chellbeth
MADISON: _maddieorendain_
Gina: rang1218
Sheri Kunovich: sheri.kunovich
Anjanette: anjaboulee
Daniel Marks: pdmarks
Zach Priddy: zachpriddy96
Kathryn Cook: kathrynbcook
Melissa Powell: melfranpow
Brian Wakefield: wakefieldbrianl
Christina Saczek: christinasaczek
Lauran Plaskoff Weiner: txweiners
Jack Froelich: jack_froelich_21
Lora Harmon: hansamrocks
Ivana Pignanelli: ivana.pignanelli
Cooper Graham: mr_applesauce73
Linda Vandercook: lindavandercook
Eve Miller: eve_millerr
kendall: kendallsieling
Jessica G Behar: jessicabeharg
: che_louisiana
: lanabwilliams
Anthony Apollaro: anthonyapo25
Mikayla Navarro: mikaylanavarro_17
Rachel Laufer Stock: rachali1
Jennifer LeLash: texaslelash
Bendelagi_: bendelagi_
Joe Manna: joebananamanna
Megan Conlon: megansconlon
Lauren Lea: laurenblea
B r i l o n: brilon_addison
Dayna Newell Kline: daynankline
Angie Simmons: angie__simmons
river: rivere_06
Everyday Is A Reason To Smile!: kate._.lawrence._.217._
Emily McDaniel: mammalicious13
Molly Schroepfer: mollyschroepfer
Christina Herubin Hernandez: christinaherubin
Claire Turner: turnerlclaire
Julianne Brawner Hoerman: jhoerman
Kathy Stevens: shecalledmesassy
Kathy: kdelavergne
Stefani Musick: stefanimusick
hallieutkov1: hallieutkov1
Katherine Matamoros: kathymat_
brianlaker: brianlaker
Avawayne: avawayne8
The Haven Wellness Center: thehavenwellnesscenter
Alexandra Martin Hatting: alexandramartinhatting
Jennifer Silman Ortiz: jennifer.s.ortiz.7
Julie Sayah: sayahjulie
cwneilson5: cwneilson5
Nathan England: e4england
Abby Lockard Lane: mommaloves2shop
Tammy Olsen: olsenfamily
Draper: drapercannon
Tommy Brown: tommybrown477
Bella Blackwell: jesusloverbella
allansneider: allansneider
Stevie Hickman: steviedeehickman
Sharon Sharp: sstylist1220
Jax Escobar: jaxpartyofthree
Ski le Gap: skilegap
Gretchen Crowder: gdcrowder
Jennifer Brewer Costello: fetchingdesigns
Alex Paramo: alexparam.o
Courtney Miller: courtneygreenmiller
Rene Trevino: exlsutiger2
Wonseleh Brewer: anointed12academy
Amanda Nikolopoulos: aspillso
Jordana McGee: jordana_mcgee
Marcia Trujillo Campagna: marciacampagna22
Caroline Moore: caroline91
f33beech: the_real_pop_tart_vr
Jemecia Adkins: a.u.g._fit
Application Edge: applicationedge
trin: trinitybyars
Steve Watson: stevewatson72
: jackiepollan11
sellersmel: sellersmel
Marissa Montgomery: marfrizmonty
Kaitlyn Moore: kaitlyn.moore3
Robin McBride: tweetie6564
Jeff Boomer Boomstein: boomerstein
Kevin Boardman: kevinboardman
betsy sayah: betsy_sayah
Kimberly Kahn: kimberly_kahn
Tara LeeAnn Powell (Beliak): tara.leeann.powell
Amanda Kerby Portugal: amanda_jayne78
Tucker Bauer: tucker5183
Melissa Harrison: melissaharrisontv
Golf Course Prints: golfcourseprints
Charlotte Scannell: charlotte__scannell
Sarah Dailey Bates: bates_sarah225
Vincent Capriotti: westrain8470528
Spicy Spencer: spicyspencer96
Jesse Garza: jesgar7
daniellepahlavan: daniellepahlavan
Dante_rivera_33: dante_rivera_33
: billie_e1ish
Russell Lee: russell.lee.3998
Amy Whaley: amydwhaley
Spencer: spencerorth_
Cheyenne Turpin: tcj96
Jake123: jkspears100
Grace Prep Academy: graceprepacademy
Charli B: charli.in.chains
Alexklitsch: alexklitsch
Phillip Carroll: coachpcarroll
Miki Johnston, LCSW-S: mikijohnstontherapy
Jayna Olsen Henstorf: jaynao
Pennies 4 Heaven Resale Store: pfhresaledallas
Hansen: hansen_graham9
Reggie Fittastik: fittastik
Micah Yancey Rust: micahyanceyrust
Robin Gordon Sells: robingordonsells
Kimberly Lynch: kimberlyslynch
Laura Schroeder: vandelaurt
Andrew Zuch: zuch.andrew
Macey: therealmacey
Jahan Ramji: jahanramji
Britt Efrain Palacios: efrain.palacios.73594
Tripp Swearingen: trippswearingen
Stephanie DeLay: stephaniedelay
mickielara: mickielara
Harrison. Montgomery: harrison.montgomery
Cara McBride Calder: carabethcalder
Amy Biesman: abiesman
Nancy Melhorn: nancymelhorn
Walnut Farm Montessori School: walnutfarm_montessori
Olivia Mitchell Robinson: _liv.robinson_
Sarah Wrigg: sjwrigg
Hillary Steinberg: hill29_
Sara Golieb: littleteacher1984
Becky Johnson: beckysjohnson
Akiba Yavneh Academy: akibayavnehacademy
Brian Sarche: brian_sarche
Jennifer Caruth Drake: jennie_annie_
Trinity Chandiramani: trinity.c17
Crystal: zcbwcbwz
Andy: andyoco
Susan Chandler: revsec
Amy Curran Smith: smithcurranamy
Rich Guerra: velo724x
Brady Dunn: bradyd46
Jd Gregson: jd_gregson48
Melissa Turner: handynomore
Meshea Matthews: sjesdallasheadofschool
Evan: evan.andro7
Kat Curtis: katcurtis5
BrookeBlackmire: brooke_bm_
Brett Levy: brettandles
LeLash Group: lelashgrouptx
Luis Felipe Suarez: lufelsuar
Catherine Marrs: marrscollegeadvising
Will Hebard: will_hebard
Whitney: whitcopp
Kim Wood: kim.wood.10004
Jennifer Douglas: justjenjen_72
Heidi Haverstock: heidihaverstock
Delaney Josephs: djosephs___34
Lance Price: lcprice97
Parenting TheFive Byarsgirls: parentingthebyarsgirls
balvir: balvir.kumar00077
Beth McGaw: launch_padconsulting
David Spain: dbspain
Blair Miller: millerslilmonster
Meagan Gordon: gabbie82
Marilyn Giles: marilyngiles
mochaaustin: mochaaustin
Alexis O'Connell: alexis.w.oconnell
Robin Weiner: robin_weiner
Sara Macha: babn26
Timber_Wolf72: mystictrash72
M. Gale & Associates: mgaleassociates
Auna Hay: aunahay
Carla Terry: carlaterry2
Jake Kreft: jake.k1304
Young Women In Bio-Texas: ywibtexas
: mothertheresiiiaaa
Martha Wardlaw Griffin: marthagriffinmom
JG: librarygem
Katherine Davis: katdavish
: ashmagen03
Carol Oakes: oakes7492
Theresa Hall Attwell: tootsmom
gracie blaylock: gracie_blaylock
: linseybpogir
Matt McClard: yankeyhotelfoxtrot
Shannon Sedwick: shannonsedwick
Christine Lynn: mrsclynn
Kimberly Love: letsmontessori
Diedre Danielle: diedredanielle
maryannewj: maryannewj
Chip Bensing: earlej8185
Lance Price: lanceaprice
Brooke Gleason: bgleason46
Brian Summerall: briansummerall
Cecil Young: coachcecilyoung
KICKIT365: kickit365
Jenny Mcclure: jenniferpaper
: tumbingwithsav
Lindsey Darrow-Cobb: southern_mama_bear_1982
Sarah Yodh: preschoolpolished
LaMarion Sue Patterson: ima_sue_you
Krista Smith Hayes: krista.m.hayes
Shelton Montessori Training: sheltonmontessoritraining
Naman: namanbhushan8
Heather Piper: piperetc
KatelynSlocum: katelyn_slocum16
Carla Calabrese: carla_calabrese
Events by Robin: eventsbyrobin
Anne Besser: annie.besser
Malar: malar2607
Sara Harris: sara.harris1212
Jessica Brazeal: jbrazeal
: bcwier
Kimberly Sloan: sloan4032
Rosaura E: rosaurae90
Jill Frady: fradyjill
North Dallas Speech: northdallasspeech
Catherine Carson: cat_carson_
Kim Vu Puyleart: kimpuyleart
Luke Polka: luke.polka
Marilee: cjomto
Toni Chris Obias Clavo: ohalestoniee_20
5: iamjuiceed
Ferd Miners: fat_boi_ferd
: thecarrigans
Mary Eckert: mary.eckert_
Charlie Magids: charliemagids
: mfilipovitch
Shy Jr: theshycowboy95
Mike Androvett: androvettmike
Elizabeth Dzina: lizard.dzina
Margaret Ellis: marheck26
Layton_Woodruff: layton_woodruff
The Ozone Bar: theozonebar
Susan Cooper: scoop19701
Chris Myers: ctmyers
Julie Kuntz: jfkuntz
: dreco_bandzz
Keith: leakywader97
Nelson•Heidi•Margot•Stella: combsdogpack
Beau Taylor: babayega53
Carney, Sandoe & Associates: carneysandoe
Samantha Hawkins: samholmeshawkins
Cuero Baseball: cuerobaseball
Tina Marie Fajita: the_korean_baker
Lisa Winkler: lisawinkla
Meredith Dodson: merbear7112
: jkijigbigd
BN Creekwalk: bncreekwalk
The Shelton Chargers Drumline: thesheltondrumline
Neysa Font: fontneysa
Grant Hughes: granthughes76
Debbie Harris: harrisdmh
Hudson Cooper: hudsoncooper7715
Casey Lynn Johnson: caselynnjohn
Colleen Kelley: c.m.kelley
Christina 'Parker' Rosen: stinaparker
Lisa Buchanan: lisabuchanandesigns
Melissa Farish: dmfarish
Naik Sejal: sh4ever_10
Zach Taylor: z_beast_79
: purpleheartemoji7
6goosey: gage_spain
The Couch Therapy: the_couch_therapy
Samantha Mitchell: smitch739
Louise Cottel Crain: louisecrain
bailey: bai.equestrian
The Hearing Loss Clinic: thehearinglossclinic
Parenting for the Present: parentingforthepresent
Mary: ocd_me_in_tx
Good Shepherd Episcopal School: gses.dallas
Jenna Krohn: jennalkrohn
Kris / John McCallum: lady_ella_of_sunnycreeklabs
GSES: Modern Learning: gses_dept_of_modern_learning
Aaron Massey: amassey
: parker.cad
Robert Contreras: robertcut
Kyle Belz: croco_kyle_dundee
Summer: welcome2brownsville
The Commit Partnership: commit2dallas
Trinity Chandiramani: trinity.c_17
Ira Brown: irabrown94
Charlie: brittanyspaniellovee
TOP SHELF DRUM LESSONS: topshelfdrumlessons
Mandy Palmer: itsmandypalmer
: madelinehoyle
: britsim
George Goodno: georgegoodno
Peace Rose Montessori: peacerosemontessori
Car Dorx: cardorx
The St. Anthony School: tsasdfw
Roberta Tijerina Mayrl: robertamayrl
Charla Miller: charlamiller__
Lakemere Learning: lakemerelearning
Suzanne McCarthy Crawford: suzanne_mccarthy_crawford
Laurel Neustadter: neustadter
jouvenal: jouvenal
Sophie Proctor: sophieproctorofficial
Tracy Benge: bengit
: louiegoree
Ruby: ruby.the.rescue.doxie
DallasCAC: dallascac
Giovanna Grampa Anderson: giovannagrampaanderson
Marty Justice Moore: martyjusticetx
Courtney Leigh: courtneyleighcoaching
Carli Michelsen: ca_carli
Megan Schmitt: megskids4
The Fletcher School: fletcherfalcons
Meadowbrook School: meadowbrookschool_dallas
Sharmeen Niazi | She/Her: mom_tessori_guide
Fusion Academy Dallas: fusiondallas.tx
cibreeze: cibreeze
Hannah Wolf: hannahwolfstudios
Joyce Morrison: joyce__morrison
The Helm ABA: thehelmaba
Muck da Empath: muckdaempath
UMSI: umsindiana
Regis University Admissions: risingrangers
Kris Smith: dyslexiawordsmith
Jordanna Cooper: jordannacooper
Mustang Athletics: ciamustangs
Don Bruno: dontopsail
The Bridge: bridgehomelessrecovery
Lake Life Cabins: lakelifecabinsok
Shady Oak Academy: shadyoakacademy
The Parish School: parishschooltx
: taylorcantrell123
Lookiewhatidid: lookiewhatidid
Project Unity: projectunityntx
Shay Geyer: designershay
North Dallas Barre - Memories: northdallasbarre
Leigh Taylor: leightayl
Steven Silverman: stevenjay2168
Alcanzando: Autism Worldwide: alcanzandoautism
Allyn Media: allynmedia
New Way Academy Language Arts: new_way_academy_la
Special Kids Tees: specialkidstees
The Buzz: greenhillbuzz
Tim Mulvihill: tim.mulvihill.98
: shelton_chargers_thunder
Amy-Ellen Voto-George: photographybyamyellen
: hookhull
Fink 3d Printing: fink3d
29 Acres: 29acres
Amarillo ISD: amarilloisd
Big D Party Rentals: bigdpartyrentals
: clancy42
: arbortree
Scott Dillow: spdillow
StandUpLD: standupld
Nicole Pritula Williams: wms_nicole
Maegan: mindlessimaginationcreates
Jen white: jenbryantwhite
Key School & Key Center: keycenter_fortworth
St. John's Episcopal School: sjesdallas
Will Dorward: will.dorward
Jack: purduepunisher
Rachael Andrews Kane: kanerachaelandrews
31st State: 31ststate
Ray: koalaray_sketches
Who Is This Anoying Kid: who_is_this__annoying_kid
The Westwood School: westwoodschooldallas
yolo: laurenclarke4
Hessa Abdalrahman: hessa_1st
Shyno Mathew: dr.shynomathew
jazmin: gorillagripglue69
Readers 2 Leaders: readers2leaders
