Susan: susanedwardsldplegdagz
Dorothy: dorothyandersonwxawjuhzum
Christopher: christopherthompsonsczrevkniv
James: jameswrightzsonxspxjj
Dorothy: dorothytayloritsoxigren
Christopher: christophercollinspdptlkntzc
Susan: susanrobertsewvjikvtzm
Emand: emand__press77
Richard: richardadamsjphakrqrxz
Dorothy: dorothycampbellwgtmbovygd
Dorothy: dorothyedwardscngmcbetpt
lexie miller: lexiegmill
avery schilling: aveschilling
Sree: sreeduggirala
Austin Gardner: austinthescholar
Alicia: alice_ia.rose
Samantha L.: sam_leidel
crystal zimmermann: crystalzimmermann_
Mia Rosenberg: miaarosenberg
Liam: liamstemetzki13
Dani Rose: danimirin11
Madi Miller: madelinemiiller
Sohaib Khan: sohcool23
Heath Harris: heath.harrisss
samantha: samanthawlodawsky
Maddie Hymowitz: maddiehymo
madisen lieberman :): madisenkate04
Ryan Karkowsky: ryankarkowsky
hannah: _hannahcleveland
Will Pechersky: willpechersky
hailey hirsch: haileyhirschh
Caleb Geyer: caleb_wisemangeyer
Sara Hickman Ridder: sararidder
Leviticus Gay (pause): luckyleviticus
Sushan Chaudhary: sushan_chaudhary1
mady kahn: madykahn
Payton Thurman: payton__thurman
Reeba Abraham: reebabraham
: rahulabraham03
alex levinson: _alex.levinson
Leah Weisglass: leahweisglass
schottman: elly.schottman
Emma Nagle: _emmanagle
Jafrina Rahman: jafrinaa
karissa: karissa.susie
Corinne Piorkowski: ccorinnep
Reagan Schluter: reagan.schluter
Jordyn: jordynfeenberg
kyra: kyra.schobel
lia bloom: lia.bloom_
Jack Newman: cactus.jack03
Maddie Mandel: maddieemandel
madi silver: madison.silver
Harrison Alexander Funk: funk.xander
Will Reed: wreed17
Carly Freeman: carlyfreeman5
isabella: isabella.rosess
Amanda: amandathegallo
Liv: livschlossman
Gia: gia.rose._
Lauren Rosen Levinson: lrlevinson
harrison: harrisonhensleyy
Austin: austin_friedman13
°katie!: katiemfield
Riley Schultz: therileyschultz
Chloe Miller: cchloemillerr
claire: claireschulter
hope vanderburg: hope.vanderburg
Ruby Manley: rubymanleyy
: drewcohen11
Jamie Brooke: jamieweinbergg
BELLA FRIEDMAN: bellafr1edman
vice: blackrabbit.xx
Fritz Thomas Stucki: xenofyen
Rosie Carlton Glassford: rosieglassford
: danifriedman_
Gabby Norman: gabby.a.norman
sage rose: sagefuhrman
tatom: tatom.hoffmann
: liam.earthman
thomas chun :): thomaschun_
Adam: adam__ily
MATTI: mattilaeskye
Mahdia Rahman: mahdiaaa._
raunak: raunakmanchanda
michaela:): michaela.huffman
Maddie Savasky: maddiesavasky
Leah Plowman: leahkplowman
betsy goodrum :): betsygoodrum
Maxwell Diamond: maxwell_diamond21
avery: averyengleman
Samantha Dworaczyk: samantha_dworaczyk_
YÍ„hÔ„ Kh·Ò: yeahiakhan_555
Abby Grosshandler: abbygrosshandler
: gucci._abraham
Daniel Tzalik: danieltzalik_
Shawn Berger Hickman: shawnybhick
manny: manny.delacerda
Adam: ad.am5141
Samantha Wiedemann: sam.wiedemann
lucy.: lucyybergerr
julia schwaeber: juliaschwaeber
: amandaharrelsonn
Michael Berman: michael_berman16
Hayley Wetzel: hayleywetzel
Samantha Lee: samfaithlee
Kristin Pitman: kristinlashelle
Luke Reed: luke_reed_44
A L E X: alexcussimanio
Dre: dre.rothb
bella martinez: bellasophiamtz
Kim Schwartz: kim_c_schwartz_
mikey gavranovich: mikeygavr
Cole Dermanoski: dcdski
Emily Schottman: emschottzy
gracie: _gkirsch
AVERY SCHWARTZ: averyschwartzzz
Lauren Silver: lauren.silver
Galiguer: galiguer_manjarrez
skylar stepp: skylarstepp
Chantz Bell: takeachantz_
Suzeth Roman: suzeth_roman
Susanna Brass: susanna.brass
Saleen Nyman: saleenbelle
Cate: cateadamss
brooke <3: brookedauderman
Lauren Schiele: la.uren_schiele
NOA MILLER: noamillerr
priya n herman: priyaherman
Pehlman ìAnything Is Possibleî: carsoooon_peeeehlman
Christy Satterfield Robinson: christyrobinson0227
Storage Scholars: storagescholarsut
mireya !!: mireyamedel
Autumn Beck Blackledge: autumnblackledge
Susan Beaubouef Quinn: susanquinntx
Ali Wayman: aliwayman
Simon John: simonkjohn
: jt_shapiro10
Jaslyn Umana: jaslyn_um
pommo: maddiepomykalski2
Manav Makhija: manavxom
harrison sager: harrison.sagerr
hayden miller: haydengmiller_
Shelby Rose: shelby.yeary
Roman Orsini: roman.o
amanda kell: amandafaithkell
Daylon Bergeron: daylonbergeron
: jsherman212
Arvis Miller: arvis_miller
Jesmin Simon: jesminsimon
Abdelrahman Gohary: abdelrahmanelgoharii
Heather Goodman Finley: lipstx4evr
Yanky Schuler Patrick: yankypatrick
Panji Akbar Sudirman: sangpetualanggg
Tonii Rom·n: antonyroman32
khan420: khan420725
Ibn E Adam: shahqamar00
simran: khan1990simran
M Anwar Kamran: manwar.kamran
peopleredemptionparty: prplagoschapter
salmaniac_yeasin: salmaniac_yeasin
okokok: khan_khan7327
Lora: lora_adam889
Ay Man: rotlot131
Rose: roselxfbhcudo
Karan khan: khan_gey
premanshi: anshi.agarwalla
areesha khan: areeshabm499
: ateferahmani220
Sandra: sandraadamsgpjmwwhinl
Donna: donnaharrislpjngivktk
meezankhan: meezankhan394
raheem: alishahkhanabcdef2021
Abdullah khan: khanabdulah2233
Michael: michaelevansvhcnznerds
imrankhan: imrankhan07175
Kenneth: kennethmillerukjlsfcufm
mdsuvokhan: mdsuvokhan2
rahena khanam: khanamrahena
: rakibkhan3737
Taqi khan: ktaqi2337
asif khan: asifkhan0349
abdur: abdurrahman976534
Jason: jasonwilliamsjtxfyczbbc
: 1ayankhan1
Sharon: sharongarciaczzwpxbflw
poyan: poyankhan1y
: salmankire7
Susan: susanhernandezxxebsgyrbo
Laura: lauramillergfshwiwylp
mahi_thoughtz: mahi_thoughtz
Dorothy: dorothywilliamstenbbhkood
rida khan: krida6258
Susan: susanbakerxoyzuyjbyu
Nancy: nancyadamsibnqfzposa
