Adam Lai: adam__lai
Owen Goldberg: owengoldberg
Will Pechersky: willpechersky
Shannon Saalfield Thompson: shannonsaalfieldthompson
Sumana: sumanakethu
Sky Park: skypark15
Matthew Shen: meefuisgood
Danielle Maxfield Clayton: petuniamom77
kathryn b sands: katzbsands
adi s: byogaman
Andrea O Norman: andiold
Stephen Fitzpatrick: fitztcu
Manushi Khasgiwala: manushikhasgiwala
Cole Norman: colenorman4
Luke Laczkowski: luke_latch
Erin Foley Schuhmacher: eschuhmacher
Jake Robinowitz: jakerobinowitz
Hudson Bloom: hudson_bloom
Zoheb Khan: zo.heb
Julie Williams Pechersky: juliepechersky
Owen Simon: owenlsimon
Nathaniel Fisher: nathanielfisher7
Sumana Gangi: sumanagangi
Amy Albers Laczkowski: aalaczkowski
Jake Laufenberg: jake.laufenberg
Tate Laczkowski: tatelacz
Angela Winterle: angelawinterle
Brenda Mandeville Then: danemomof2
Gayle Goldman Johansen: gaylejohansen
Henry Schechter: sheckmojr
Margie Nussbaumer: margienuss
Erica Simon: oskitx
Aparna Mankodi Crosnoe: amcrosnoe
Kimberly Haley-Coleman: kimboglobeaware
Jackson Lutz: jackson_lutz18
Rashmi Mankodi: rcmankodi
David Schechter: sheckmo
