Filtered Followers:

NINA RALSKY: ninaralsky
hailey hirsch: haileyhirschh
Samantha L.: sam_leidel
Dani Rose: danimirin11
Austin Gardner: austinthescholar
Lucy Simon: lucysimon_4
Sree: sreeduggirala
crystal zimmermann: crystalzimmermann_
•sophia black•: sophiablackk_
Emma Nagle: _emmanagle
Luke Schweizer: schweizerluke
: rahulabraham03
Storage Scholars: storagescholarsut
madisen lieberman :): madisenkate04
halle schenk: halleschenk
kourtney miller: kourtneyymiller
Heath Harris: heath.harrisss
tatom: tatom.hoffmann
Victoria Mentzer: victoria.mentzer
Wade Arntzen: wadearntzen
Brady Schlosser: bradythedude
Terri deGarbolewski: terridegarb
sage rose: sagefuhrman
Edward Schock: edward_schock
Sushan Chaudhary: sushan_chaudhary1
Maxwell Diamond: maxwell_diamond21
Sara Hickman Ridder: sararidder
Ryan Karkowsky: ryankarkowsky
Daniela Schmeichler: danielaschmeichler
: drewcohen11
Maddie Mandel: maddieemandel
Riley Schultz: therileyschultz
OLIVIA JACOBSON: livvvjacobson
Charlie Satenberg: charliesatenberg
Mikayla M.: itz.lyricxl
: jordynfeenberg
Ruby Manley: rubymanleyy
harrison: harrisonhensleyy
Holli Ahiers: holliroseahiers
Ryan Salaman: ryansalaman/
Payton Thurman: payton__thurman
Milkman: bordenwyatt
Liv: livschlossman
emily achtermann: emilyachtermann/
Kenna Tolman: kennatolman
Harrison B: harrison_b4
julia schwaeber: juliaschwaeber
Lauren Greenbaum Laitman: lululaitman
Liam: liamstemetzki13/
claire: claireschulter
William Braffman: wbraffman/
Caleb Fleischmann: calebfleischmann/
mady kahn: madykahn
ryssa:): aryssa.camenisch
lauren lindemann: laurenlindemann_
Lauren Rose: lauren.rose3
hope vanderburg: hope.vanderburg
nicole: nikki_hilscher
• virginia nussbaumer •: virginia_nuss
thomas chun :): thomaschun_
Elena Khanlarbeik: elena.khanlarbeik
Stephaniehultman: steffiebhultman
Austin: austin_friedman13/
Reagan Schluter: reagan.schluter/
amanda: amandafoy_
kenna dahlberg: kennadahlberg
Matthew Shapiro: matthewshapiro_/
Chloe Miller: cchloemillerr
Manan Khandelwal: manan_k04
Ski: rahman._md_
Alana: alana.bowman2021
: adamrosemann/
ari b: arianabhimani
aidyn neiman: aidynneiman
Angela Tatsch: angela13_764
k r i s: kkristenharris/
alex: alexx.goodwinn
: levii.robinson
: amandaharrelsonn
Jace Petrovich: jace.petrovich/
A L E X: alexcussimanio
Luke Reed: luke_reed_44
: liam.earthman
AVERY: averyschwartzzz
hadley adams: hadleygadams
Stephanie Schmadeke: snealslp
Mar: maritza.mcneal
Samantha White: samantha.janelle
Will Pechersky: willpechersky
sam: samantha.hailey18
Maddie Savasky: maddiesavasky
: jaretzycavazos
Sydnie Simon: sydnie.simon
Brookelyn Mayfield: brookelyn_dmay
Samantha Lee: samfaithlee
Samantha!: samantha.dahlin
hannah: _hannahcleveland
Jennifer Mancha: jennifer_mancha1
Chantz Bell: takeachantz_
Sophia Rose LaCrosse: sophia.rose.lacrosse
zev gordman: zevgordman
Cole Sorosky: cole_tyler27/
Abby Grosshandler: abbygrosshandler
Lindsay: lindsay.baronoskie
mireya !!: mireyamedel
brie: brie.schaff
Samantha Dworaczyk: samantha_dworaczyk_
t a y l o r :): taylorrharris._
katelyn perryman: katelyn.gp
mikey gavranovich: mikeygavr/
Karen Itzel Cazares: karencazares14
ella burgess: ella.burgesss
Luke: luke_hartfield
ANNA SCHLETT: annaschlett_
Sammie: samantha_vermeulen
roselyn <3: roselynnnn_c
katz: katiaa_bc
ISAIAH Morrison: spiderman20andeadpool20
: jordynsskye/
aashna mangal: aash.na_m
: elissse.bowman
katie schott: katie.schott
Tina Rose: tina.r0se
mercer :): mercer_schulte
skylar stepp: skylarstepp
: joeman.1
taliyah harris: taliyah404
Dylan: dylan2flamand
Cate: cateadamss
Ali Wayman: aliwayman
autumn rose: autumn.haney
Leander High School c/o 2022: lhs.co.2022
Yvette Betty Geigenmiller: noobbetty
