alex levinson: _alex.levinson/
lexie miller: lexiegmill
Jesmin Simon: jesminsimon
Simon John: simonkjohn
aashna mangal: aash.na_m
kenna dahlberg: kennadahlberg
: danifriedman_
Jordyn: jordynfeenberg
Giana Abraham: giana.abraham
sanjana: sanjana.khanna_
manny: manny.delacerda
pspspsrose: deismos
x i x i: xixi.hillman
Adam: adam__ily
Aidan Manning: amanning___
Henry Roth: henryroth10
Caleb Fleischmann: calebfleischmann/
jess: jesssilverstein
Dishita Awataney: dishthefish2194
crystal zimmermann: crystalzimmermann_
Samantha Lee: samfaithlee
Lauren Silver: lauren.silver
Cole Sorosky: cole_tyler27
katie schott: katie.schott
mady kahn: madykahn
Ali Wayman: aliwayman
Lauren Rose: lauren.rose3
schottman: elly.schottman
: jt_shapiro10
nicole: nikki_hilscher
Zach Arenberg: zarenberg21
Zaria Cleveland: itsjustzaria21
ella burgess: ella.burgesss
zev gordman: zevgordman/
Storage Scholars: storagescholarsut
Suzeth Roman: suzeth_roman
lucy.: lucyybergerr
Samantha L.: sam_leidel
julia schwaeber: juliaschwaeber
London: llack_124
: puzzleman568
Matthew Shapiro: matthewshapiro_
pommo: maddiepomykalski2
Autumn Beck Blackledge: autumnblackledge
Pehlman “Anything Is Possible”: carsoooon_peeeehlman/
Susanna Brass: susanna.brass
Chloe Miller: cchloemillerr
Luke Schweizer: schweizerluke
brooke <3: brookedauderman
Liam: liamstemetzki13/
Liv: livschlossman
meghna subramanium: meghnasubramanium
Charlie Satenberg: charliesatenberg
Jamie Brooke: jamieweinbergg
Mia Rosenberg: miaarosenberg
Corinne Piorkowski: ccorinnep
claire: claireschulter
Shelby Rose: shelby.yeary
Carly Freeman: carlyfreeman5
Jonathan Nachman: jonathan.nachman
priya n herman: priyaherman
: isha.ramann
Naman Bhakta: namanbhakta051
ash manoj <3: ash.manoj14
Maddie Savasky: maddiesavasky
: rahulabraham03
roselyn: rosssselyn
Austin: austin_friedman13
sage rose: sagefuhrman
Chantz Bell: takeachantz_
avery schilling: aveschilling
Mahdia Rahman: mahdiaaa._
katz: katiaa_bc
raunak: raunakmanchanda
Dorothy Macias: dorothyalexis__
Samantha!: samantha.dahlin
Ruby Manley: rubymanleyy
CAROLYN KANE-BERMAN: carolyn.kb
Reagan Schluter: reagan.schluter
hannah: _hannahcleveland
Payton Thurman: payton__thurman
Maddie Hymowitz: maddiehymo
Victoria Mentzer: victoria.mentzer
Ryan Karkowsky: ryankarkowsky
ari b: arianabhimani
hayden miller: haydengmiller_
lauren lindemann: laurenlindemann_
Alicia: alice_ia.rose
Ellie Basta: elliebasta
avery: averyengleman
ANNA SCHLETT: annaschlett_
BELLA FRIEDMAN: bellafr1edman
Mar: maritza.mcneal
Luke Miller: lukemlr
tatom: tatom.hoffmann
skylar stepp: skylarstepp
premanshi: anshi.agarwalla
•sophia black•: sophiablackk_
Sydnie Simon: sydnie.simon
katelyn perryman: katelyn.gp
hailey hirsch: haileyhirschh
Lucy Simon: lucysimon_4
Emma Nagle: _emmanagle
Heath Harris: heath.harrisss
halle schenk: halleschenk
Reeba Abraham: reebabraham
madisen lieberman :): madisenkate04
aidyn neiman: aidynneiman
• virginia nussbaumer •: virginia_nuss
Saleen Nyman: saleenbelle
Gabby Norman: gabby.a.norman
AVERY SCHWARTZ: averyschwartzzz
Maxwell Diamond: maxwell_diamond21
Maddie Mandel: maddieemandel
Cate: cateadamss
amanda: amandafoy_
Austin Gardner: austinthescholar
Dani Rose: danimirin11
: amandaharrelsonn
dw: dawson.wolff
samantha: samanthawlodawsky
hope vanderburg: hope.vanderburg
kourtney miller: kourtneyymiller
