Filtered Followers:

Big Apple's Fried & Fresh: bigapplesfriedfresh
dio :\: da_gotz
Mickie Solberg Turner: micks73
: itzz_holiday_
Abeer Khan: abeerkhan51
Spencer Neumann: spencerneumann1
Martin Van Den Bossche: martini_j_vdb
Sam Lack: s.lack55
Road Ready Driving School: roadreadytx
Yuval Cohen: yuvallikesmandms
Jennifer Danburg: jkdanfix
rachel schwartz: rachelschwartzzzzzz
Zev: z.goetz23
Sarit Ohana: sarit_cohen
Le vie dorate: leviedorateit2
Bellaire Chess Club: bhschesss
Noah Hanson: monkeyman_noah
borderline chaos fish tank: borderlinechaosfish
: fishybhs
Stephen Spielman: sspielman15
: t.aviirosee
BeeReaders Español: bee_readersusa
Samiha Zaman: samt_zam
mani: guess_my_name_sam
Lyra Guzman: lyiraguzman
Jeff Kaufman: j.monkeyfish
manuel: heyitzmanuel
Twilight Wolfe: wolfetwilight
: gytzelleduran
John Seifert: jseifertn
: jmwgoetz
Mrs. Van Den Bossche: mrs.vandenbossche
bermudez sandra: bermudez_sandra359
Aaron Newman: foos3y_ow
Sophie <3: _scohen_
contessa,sal,damarion,moses: chaosaqs.pd6
nicole: iitz.nicolee
ella marie rose <3: ellaaa.casttt
Amanda Huttenbach: amandahuttenbach
: agoodtrip_aqs
edit grossman churchill: egcmama_of3
Chloe Lin :): chloelin_freshmanhoco
Matthew Tran: matthew_the_stegoman
Bellaire High School AAA: bellaire_aaa
Roman Williams: roman_williams7391
Jessica Lee Freedson: jessicafreedson
THE GOLDFISH: thegoldfish_aqs
Eman: eman3_64
Monica Guzman: la_moni_guzman
Heidi Seifert: hseiferttt
Destiny Thompkins: duhh.itzdezzy
: filip_pacz
North Forest High School: northforesthighschool
Jesus DeLeon: jesusdl9
Matias Kopinsky: matiasforhisd
Sharpstown Intl School: sistocollege
Trace Gorman: trace.gorman
Wyatt: wyattmann2009
Adam Ardolino: adamardolino
Bellaire High School Football: bellaire.football
Nicolette <3: itz._nikki
Shelly Grogin Schultz: schultzsmiles
Mandie Peel: mandiepeel
: braydenblackburn06
Josh Freedman: sea.pigeon.what
jenny katzen: jgkatzen
Ethan Goldberg: ethangoldbergbhs
Harrison Shim: shimharrison
amelie: amelierozowski
bridget: bcrossman_
Susan Fitzgerald: sus.fitz
Kyler: skinnyviibess
Stevenson Middle School: wistevensonms
Trin<3: itztrinnnn
Porsche Anderson: mspea85
armani: 832skrilla
angel fernando bruno román: angel_fernando_roman
nina!!: nina_hosch_
samantha: samiidkman
: wolfxf4d3d
: vibeswithskyyyy
Courtney Adams: grizzlieadamz_bse
Adam_07: adam_075160
Liza Karmanova: liz.karmanova
Rowan Freedson: rowanfreedson
Samantha: itz._sam1
GoManda: gomanda_app
emmy: throbby.schmurda
: laurenblackburn03
Joel Forman | Financial Expert: formansfinancialfacts
Christine Krofel Pisarski: chrisp64
Melissa Miller Martin: martiniswife
Elise Lowe Newman: elisenew5
Jacob Levine: jacoblevine2656
amanda roberts: amandaroberts08
Pin Oak Middle School: pinoakchargers
Austin High School NHS: nhsaustinhs
Brandon Chu: brandonseinachu
Uptown Sushi | 713.871.1200: uptownsushi
Jacob Levine: jacoblevine4748
Rose Orduna: roseorduna
: ambermialaura4booster
Christine Mansfield: cmansfield7
Deborah Mansfield: deborah.mansfield7
Susan Gaeta: susgaeta
: godschild_jewelz
: _manyrubio_
Mia Zilberman: mia.faye7
: hisdvschool
daphne kaufman: daphne.kaufman
Greg Sherman: iratello
FEdream: fulfilleverydream
Andrea Berger Freedman: andreabergerfreedman
Bellaire High School Hindi: bhs.hindi
Iman Suleman: imansuleman125
Hanan Suleman: hkimsl
Gavin Sherman: gsherman4
Sarah Lack: sarah.lack01
: leslieeg_.mrtz
Jared Goldberger: goldbergerjared
Jessica Lusky Evans: jrlevans
Jacob Flores Levine: jacobfloreslevine
Daniella Guzman: beactiveinstyle
HoustonISD School Choice: hisdchoice
West Briar Middle School: westbriarms
Hannah Kraut: hannah_kraut1
Clarke Adams: itz.clarke
Charles F. Hartman: hartman_ms
Jennifer Lea Kuhleman: jenniferleakuhleman
Maggie Schwierking: maggie.schwierking
Amy Kaufman: mrsladyhead
The Knight School - Houston: theknightschool.houston
amy: blue_rose87
reagan michelle: reaganmwise
Brandon: brandonadams3566
KARIS CHEN: karischen.05
Jacob Levine: jacoblevine91
Minister-Mina WarButterfly Adams: godz_butterfly7
Annie Ransom: ransomannie
SamanthaReyes: vibewith.samantha
Julie Goldberger: jbgoldberger
Daniella Schneider: schneider_daniella
Betty Loeschner: bettsulo
Sharron Buschman: sharronbuschman
Chris DeArman: cddearman
Marlo Thomas-Miller: marlomiller
Christina Kontos: kontoschristina
Max Feferman: max_feferman
Harrison D: hzzon24
Lisa Greenfield Ostrin: lisaostrin
Khanh Nguyen: kkhanh.p
Miles Newman: milesohnewman
: mouseskits
Harrison Mistich: drummerboy_harrison
Houston high school tea: houstonhsshaderoom
Sandman Academy: sandman_academy
Adam Deutsch: _adamdeutsch
Elisa Adams: _elisa_adams
Lori Gutman Slater: lorigutmanslater
adrian: adrian.kottwitz
The Rice School HISD: ricehisd
School of Rock West U: sorwestu
OFA Bellaire High School: optforactionbhs
Jennifer Schonen Placencia: schonen33
jacoblevine6202: jacoblevine6202
Ebelise Burgos: lachefjuana25
Crisabella Vandenbossche: crisabella1980
Pin Oak Middle School PTO: pinoakpto
Austin Schmidt: austin_schmidt1
Energy Institute High School: energyihs
Laura Manchee Designs: lauramancheedesigns
Melanie: melaniewiseone
Julie Schwalen Lee: jschwalenlee
Saul A Segovia: asking_alejandro
Mykle Harris: mykleharris
Diane Love Maness: missylove14
Joseph Vissarionovich Stalin: the_real_joseph_stalin_1878
Jamie Loeschner Burress: jburress212
Kaiyan Jing: diff_tz
Austin High School (Houston): austinhshouston
Amanda Zepeda: amanda.zepeda2229
Atlas Scholars: atlasscholars
Rebecca Rentz: rebeccar_htown
sloan goodman: sloan.goodman
Audrey: audreyfreedman_
Helen Swiff-Goodman: swiffgoeverywhere
Four W’s Fishing Team: fourwsfishingteam
Cullen Middle School: cullenmsbobcats
Melissa Gerber Brams: melissabrams
East Early College High School: east_echs
dani: danmanhopeiwin2
Tandrew: pandamantan
Manju Rungta: manjurungta
itzzz_vanessa7: itzzz_vanessa7
Susan Lewis Childs: susanchilds101
Lawrence Chee: dynachee
Westside High School Orchestra: westsidehsorchestra
Presbyterian School Alumni: ps_alumni
Walnut Bend Elementary School: walnutbendes
jaylen reitz: tussin_dm
Jill: jlack72
: redfish52020
DiscoBots: discobotz
Iamwho Iam: _redmanxx
Daryl Freedman: darylfreedman
Tiffany Spears: itztiff_tiff_
m <3: famouskiara_
angelia Miller Russell: angeliamillerrussell
Julie: juliebarker1121
Christina Levay: chrissylevay21
Lauren Bollman: laurenbollman
BHS 23’ AHFC: anneliese.switzer
Chancze: chazzinton
Paige: misshellmann
Kelly Bluhm: kabloomey
Stephen Schrock: ss_schrocko
: jessicaisahuman
Amy Wise: amicawise
Madi: _madihartzog
Tanglewood Middle School: tanglewoodmsgators
: selfishbhs
malaika khan: malaika3346
keira: keirabananaman
HISD ROSES: hisdroses
Iman Kamal: iman.kamal.31945
Latasha Rose Whiting: timeless1
Amy Harris Tan: amyetan
Ryan Hartzog: ryanhartzog
Zachary Guo: asphaltzach
Adam Remels: areme21
Sonya: sonyadearman
Zack Portman: zack.portman
Aditya Markhan: gay_alliance_bellairehs
Dantae Harris: _missuniverseonly_
Ellie: natashaskii
Marytza Fuentes: principessa_croce
Zack Portman: portmandesigns
HMS Cheer: ahmshuskycheer
Skye: skye.sus
Jason Freeman: dazzling.ideas
Lisa Birenbaum: lbirenbaum
Madeleine Wildt: wildtmadeleine
Bryanna M.: itz_bryanna0105
Deirdre Duncan Rozowski: rozowski5
Angelica Munoz: angy.munozguzman
Sonnet Mandell: sonnetmandell
William Rosen: coolademan101
Pershing Middle School: pershing.middle.school
Nick: nyckski
yeva: yeva.raichman
Rachel Fisher: rachelfisher.tx
: msfieldsslpa
MangoTrees+DancingInTheRain: sophea.arella
John Field: john_c_field
Veronica Lee Strulovich: veronicaleestrulovich
Damian Man: videocrshed
Daniel: j_d_mangupli_
Azhianamann: azh._.finsta._.prdtttt
Susan Livitz: susan_livitz_
Landrus Fields II: blackmessiah
Catalina Schultz: catschultz07
: itz_jessyy.jay
Lindsay Nussbaum: lindsaynussbaum_tutoring
Alan Lin: longwinter2000
Lillian Harris: lilmharris
Keelen Coleman: imyse_keelen4l
Adi: whats_good.adi
Cheez: _lelifeofjesus_
LaTasha Meschelle: iamimpeccable713
Sara Wolf: swolf1236
Malcolm Fields: malcolm.fields23
samantha: samantha.wexler_22
Saul Manzanares: saul_m212
AllAmerican High School Sports: allamericanhighschool
BlackshearEHISD: blackshearehisd
Anne Baumgarten Willhite: awillhite6
Abigail: abigailgoldenberg
Allie: allievandenbossche
: alicefisher100
Janann Mohring Pittman: janannmohring
: ryanedelheit
Bellaire High School Prom 2019: bellaireprom2019
John Huang: that_.silverado
Denise Coleman: pearlzandgirlz
KT Trimbur-Glenn: kttrimburglenn
Jesus Reagon: jesusreagon
Andy Oretsky: andyodoc
Jacob Levine: jacoblevine6
-,' j u n i o r ',-: juniormrtzz
Daniel Harris: danielharris_34
Bellaire High School Fashion: bhs.style
Westbury High School LULAC: westburylulac
The Exclusive Gentleman: theexclusivegentleman
Elan Goetz: elangoetz
MERRITT: merritt.taper
Black Rose Educators: blackroseeducators
Elizabeth Chapman: elizabethmchapman
benny deats: dtsman
l il ex trablack: lilextrablack
Zamani Gentry-Stringfellow: iamzamanigentry
Alexa Hayley Schwartz: alexahschwartz
Jesus-Elvira Baca: elvirajesusbaca
Starfishes of Bellaire: starfishes_of_bhs
Jodie Jiles: defenderhighschoolsports
Amy Wildt: amywildt504
Levi Fox: levifox05
Cindi Chilcoat Denman: cindichilcoat
Minerva Rojas-Lopez: minnieitzel
BHS Choir: bellairehschoir
Susana Morell: shieldinghearts
Ellery Strength: somanycelerysticks
Hillary Schulze: hillrunning
GabyGoodweather Event Services: gaby_goodweather
Ian: ianjackmann
Candace Adams-Desrosiers: candace_desrosiers
Jayla: _jayla.harrison
Megan Fitzgerald: makesmefunny
jaylen Guzman: jaylen_guzman
David Katz: dzk212
bella: bella_mansfield
James Langenfeld: james.langenfeld
max: max.goodm4n
Ella Goodweather: ella_bryn
Cyndi Ruiz Mansfield: cruizmansfield
Julie Miley Schlegel: julieschlegel_
Adam William: williamadam1
amancio price: amancioprice_1842
Brianna Moritz: breezzyfaith
Amanda Blanch: amandablanchrealtor
ABermudez..: bermudez_ariel_i
Susanna Dokupil: susanna_dokupil
Elsa Schachter: emschach40
Sharpstown High School: sharpstownhs
The Post Oak School: postoakschool
Skylar S. BHS: skylariscolorful
Chris Osterhaus: osterhauschris
susi garza: guzman1958
Rachel: mama_burgan
Lynne Sustala: lynnes1208
"together we can": pink_diamond_sports
St. Pius X High School: stpiusxhouston
Bellaire High School JROTC: bhsjrotc
Rsamantha725: rsamantha725
Manual Goth Window: x3manualgothwindowx3
Christy Furman: normanwilsonrealty
Tawnya Schoech: schoechrules
Charles H. Milby High School: milby_memories
Maritza Barillas: liz.barillas
Elisabeth Umanzor: elisau02
Susan Messina Legge: messinasm
The Theriot Brothers: thetheriotbrothers
Jerel Twyman: jereltwyman
Lindsay Nussbaum Levin: lindsaynussbaumlevin
lizschlitzberger: lizschlitzberger
John Carter: telmartman1
Leslie Crossman: leslielouisec
leslie: leslieburkes1
Ed Wolff: edwolfftx
Porcha Gordon: iamporchagordon
: kschak27
Tina Blum Cohen: tinacohen18
Decebian Hunter: itz_d25
Julie Bellinger: juliebellinger
Sarah Eshelman: seshelman4
Erick Eshelman: erick.eshelman
Valerie: val_harrison
Kscholastic Inc.: kscholasticinc
Holli: holliharrison94
Sharonda Reed: bcnu2016
Emily Herrington Hartzog: ehartzog
Sam Goldenberg: samandbread
Daniel Wachsberg: d_wachsberg
David Manzanares-Salguero: david_guitar2024
: nogoodnamesleft___
Monique Black: theelementaryclassroom
Bellaire High School LULAC: bellairelulac
Carnegie Vanguard High School: carnegievanguard
Lara Leigh Bergoon: ll_bergoon
Jerry Built Homegrown Burgers: jerrybuilt_burgers
Tricia Wisenbaker Magilke: tmagilke
Reece Lehmann: ricalo1234
