Filtered Followers:

Brianna Chan: briannachxn
Adam Lai: adam__lai
Mithun Balasubramanian: iiaviator
meghna subramanium: meghnasubramanium
Ariel: arielschachter32
Elizabeth Panzer Satz: epsatz
luke: luke.matz
Jason Shulman: _jasonshulman
Marin Rose Shafer: marin_shafer
Julian Coleman: thejuboycoleman
Rahif Mansoor: rahifmansoor
Samantha Goodman: samantha_goodman22
Nitisha Manikandesh: nitisha_m13
cat selman: cselman319
Leah Weisglass: leahweisglass
Nathan Henochowicz: nathan.heno
Kyla Schults: kylaschults23
umangi: umangisingh
Hashim Khan: hashimadilkhan
Moe Chapman: guacamolly_chapman
omer: omertzivon
Tyler S.: tyman35
Liz: lizhastoomanyhobbies
emily korenman: emilymkorenman
: louna_wolff
Charlie Selman: charmondo360
Alison Fitzgerald Grzyb: alisonintx
naomi: naomilevine_
Sam Schuring: samschuring.27
Ellie Rauschmayer: ellie_rausc
Averie: averiemintzz
michelle: michelleabraham10
Lacey Braschler: laceybraschler
Elyse Greenberg Yoss: elyseyoss
kaiya: kaiyaaadams
Plano West Wolf Den PTSA: planowestptsa
