Followers:

JANE: jane_zeltner
Lindsay Jacob: lindsayjacob_
Brian Zhang: brianzhang11
jordan: _jordanrosen
Michael Bellantoni: michael_bellantoni
NicolasPB: nicolaspb_04
: amicuccimatteo4
Olivia Addeo: oliviaaddeo
Nick Ishkanian: nickishkanian
Ethan Lewis: eluninja
Tony afonso: tony.afonso7
Jacob Geyman: jacob_geyman
nicole di paolo: nicole_dipaolo
: markiannychka
Ben Rothenberg: rothenberg.ben
abby: abby_krupa
Nora Lowe: nora_evlin
Charlotte Brown: charlotte.brown_13
Maximus Santos: maximussantos125
bella :): isabellascaffidi
brooke mozarsky: brookemozarskyy
Nicole Ramirez: nicoleeramz
Alyssa DiPietro: alyssandipietro
Ilana Kersh: ilanakersh
zoe: zoebanko_
Grace Corelli: gracecorelli
calvin: calvincai_
Andrea: andreadk313
Edith Bachmann: bonjouredie
Matt Marinozzi: mattyice_926
Cyrille Jousse: jousseman
Alana Curley: alanacurley
Aiden Heffner: aiden_heffner
Jack Blackmar: jackblackmar
Yally: izzyyallof
Sarina Metsch: _sarina.1
Jennifer Rella: jennresq
Beth Corelli: bethcorelli
Sam Hadiono: sammshimi
Rose Tse: tse633
Ella Horowitz: horowitzella
: paleykirschner
jenna: jkleynerman
Harrison Boyd: harrisonboyd8907
Daniela Marder: danielamarder
Anthony (Tony) O'Hare: tony_oh716
Nicholas Kramer: n1cholas.i
Deborah Varghese: deborah_varghese
Danny Bernstein: dannybernstein21
Jessica Dworkis Tabankin: jtabankin
MADDIE NERO: maddie_nero
Liv: livschlossman
Reg: reginabisgaier
Lia: lia.aldealustig
: lucykwittken
Aidan Schissler: aidanschissler
sarah karoff: sarahhjordynn
Evan: evanweiss32
Fred Saltstein: fredsaltstein
Tracey: traceyw5
Emma Klarsfeld: emmaklarsfeld
: bhhs.bipoc.lgbtq
Eashan Goel: eash.goel928
carolina baquero <3: carolinabaquero_
: stefanieglusky
Hannah Rippy: hannahrippyy
Christine Parisi: christine_parisi_
Alex Kahn: alexkahn12
Jordyn Bernard: jrdynb
Marianna: mariannavataj
emily pizzorusso :)): emilypizzorusso
Harli Rappaport: harlirapp
Nolan Hecht: nolanhecht
Max Colella: maxcolella
Ryan Salaman: ryansalaman
Chris You: chrisyou2
gina ;)))): ginaschiliro_
Brian Rippy: brianrippyy
aidan aldea-lustig: aidan.aldealustig
Chiara Monteforte: chiarathediva1
soph :)): sophia.livanos
Victoria Soller: victoriasoller
: jilliannicholss
Logan Rabe: logan._.rabe
Abby: abby_cushman
John Anthony Loumbas: loumbas_
Ethan Cushman: heycushman
Olivia Selkin: liv_selkin
Daniel: dahern03
Drew Krevolin: drewkrevolin
joey skye: joeyschachter
Joe Cipriano: joecip99
Pui Cheung: puister8
Tyler Bond: tyler_x_bond
: lukekovensky
Joseph Kramer: joe_kramer__
Tamar Wiener Schweitzer: tamarschweitzer
Ethan Wolland: ethan_wolland
Nathan Hwang: nathan.hwang
dwayne “the rock” johnson: ughh.lexx
: chrislq31
Kt: katiedegeorges
Tara Deeks: taradeeks
Jason Selkin: jasonselkin
Josie Lombardi: mama_tooth
Alec Miller: alecmiller_
: marlee8714
Kelsey Vaquero: kelseyvaquero
: james29a
Zach: zachberkowitz_
Nowell Gibson: nowellgibson
Michael Rocco: michaelrocco9
Jason Daly: jason_daly2025
Jacqueline Cohen: jacqui.cohen
chloe: chlofang
Hudson Schantz: hudsonschantz
Ben Goldman: bgoldy25
sabrina sawhny: sabrina.sawhnyyy
Alex Yallof: alexyallof_
Adam: adamlefk0
Nico Bisgaier: nico.bisgaier
Lorenzo Amorosino: lorenzo_ba7
Ella: ellafleischr
sydney levy :): sydmlevy
Robbie Oestreich: robertzachary_
Aidan Berkman: aidan_berkman
AVA FRANKEL: ava.frankel
Charlie Zimmerman: charliezim_
Michael Vaquero: michael.vaquero
J :): just_esco5
Jordan Bledsoe: jordan_vspwestchester
michael pierce: micheal_pierce_
Amy Nicholas Yallof: ayallof
Lila Klarsfeld: lilaklarsfeld
: sydnishamus
Jake: jakef622
Dylan Haber: dylan_haber5
Gaby Cohen: gabycohenn
Emmett Wolland: emmettwolland
Jennifer Dreilinger: jdkdesign.inc
jamie spielberg: jamie.spielberg
charlotte karp: charlottekarp_
Charlotte Rosee: charosee_
: kennetharthurgeorgedinkeljr
Casey Schreck: caseys5_
Benny Rakower: brakower1
Jake Levy: jakelevy916
Nicoleta Vataj: nicoletavataj
Jessica Weinstein Rosh: jessrosh
katerina: kkatschmidt
arielle: arielleragals
samantha grech: samanthagrechh
Vinny Villani: vinnyvillani1530
em: emilyhollander_
Ben Dreilinger: bendreilingerr
Olivia Tedesco: oliviatedesco_
Evelyne Gibson-Spross: gibsonspross
Bobby Ziff: bobbyziff26
Lily Auster: lilyauster
Lilly Sanders: lillydsanders
David Pereira: david_pereira_10
Josh Spiegel: joshspiegel_
sammy glusky: sammyglusky
: a_gonzo24
: elina_stefanopoulos
Space Punk: nyspacepunk
Bobby Chicoine: bobbychicoine8
NOAH™: coachnoahleon
Arielle Goldman: ariellegoldmann
Eva Shrayer: evashrayer
hallie: halliereiss
Marco Kingston: marco.kingston3
Erikcipriano_21: erikcipriano_21
lexxx: lexiweisss
Evan boekel: eboekel2004
Julia Barthelmes: julia_barthelmes
Jed Strober: jedstrober
Alyssa Margolin: alyssa.margolin
Luke Valcich: lukevalcich
Jake Goldman: jgoldie7
Owen Kirkwood: owenkirkwood3
Deb: goldmanfam
Kim Brown Fazio: kim_fazio
Simone Eva: therealsimoneeva
Gino Secchiano: ginosecchiano
Noah Lefkowitz: noahlefko
Bella Olivieri: bellaolivierii
Trisha Blackmar: tbjk32
Jesse Wild: jesse.wild
Corina Livanos: corinalivanos
Anthony Zeppieri: anthony.zeppieri
alana foreman: alanaforeman
Hayden Weiss: weisshayden
Jason Mauro: jasonmauro210
claire verzello: claireverzello
sydney :): sydneydordikk
Justin Barad: justinbarad
Lucy Ross: lucyyyross
Gigi Farrelly: gigifarrelly
Brooke Altman: brookeaaltman
Lara Fenig Stangel: larakim28
peyt: peytonfishman
jess: jess.pedersen_
Mason Jacob: masonbjacob
Felicia Zacks: feliciazacks
chloe talbot: chlotalbot
Corey Frimmer Dockswell: cdockswell
Gavin Javorsky: gavinjavorsky
Mojo: mojorocks4
Julia Hansburg: juliahansburg
Alison Shapiro Bernstein: alib4kidz
Faith Berland: faith_berland
Ansh Arvati: ansharvati
audrey monique: audreyrosenbergg
Rosana Cohen: rosana_cohen127
finn: finnley.sil
sof: sofmahairas
Ari Tabankin: ari.tabankinn
Billy Gillespie: billygillespie7
Jackson Smith: jackhaysmith_15
Will Harrison: willharrison4
Drew Schneider: drewschneidz_
Rick Rosenthal: rickrosenthal45
Wifi Mobile Solutions: wifimobilesolutions
: reeseertel
julia lucchino: julialucchino
Liv: oliviacorpina
Elise Fischer: elisefi10
Max Shayegani: maxshayegani
Max Margolin: maxmargolin6
Emma Z: emma.zdanoff
SAM: samanthaschaevitz
Luke Abbruzzese: lukeabb04
Chloe Siegle: chloesiegle
LILA ZACKS: lilazacks
Stephanie Diamond Auster: stephauster
Roxnyny: roxnyny
Alexis Conigliaro: alexisconig1
Byram Hills Boy’s Basketball: byramhillsbasketball
Nancy Maniscalco: nancy_maniscalco
Ethan Cushman: ethan.cushman
syd: sydneynichols12
tor: tori_shapiro
Jacob Berland: jacobberland13
Devyn Eder: devyneder
Maya Bogner: mayabogner_
Emma Sullivan: emmssully
perry ertel: perryertel
ashley weissman: ashleyweissman_
emma cohen: emmaaacohennn
: staci0619
reece geller: reece.geller
Ella Javorsky: ellajavorsky
Jamie Kaplan: jamiekaplann
A N Y L A• A S I F: anyla.asif
Max Reinhardt: maxreinhardt10
Olivia Arden Caroline Barry: livypolar
Jordan Baskind: jordanbaskind
Xx_Asteria_xX: xx_asteria_xx
Ryan Bernstein: ryanbernstein5
Christina Lucey: ch.ristina8641
Joey Brown: joey34brown
Dani Freiberg: danifreiberg
essay_elite!: homework_elite
Dylan Schimel: dylanschimel
Andrea: abshayegani
Dani Eder: daniederr
Jordyn Bernstein: jordynbernstein
caro: carolinelandesman
Ryleigh Francis: ryleigh.francis
Dollypee: marleeq_
natasha willow horowitz: natashahorowitz
sofia: sofiavcobos
: soffie_454
Jewelry by Victoria Tillotson: mementometal
Beverly Izes Cole: bevizescole
Max Rosh: maxrosh_
sydney anne: sydney.casler
The Radio Bar Guys: radiobarguys
Madonna Pedone: madonnap225
Gabriella Monteleone: gigiimonteleone
: alanchebb
Infinity New City: infinitynewcity
Christine The Phantom Queen: christine_the_phantom_queen
Byram Drip: bhhs.drip
: kailyn.sawhny
Gumdrop Lane: gumdrop_lane
Shdjfjcjcuc: suvhcnsneididi
Scott Foreman: sthrottlemeyer
: used4backup
