Filtered Followers:

Uyanga Batsaikhan: uyanga_batsaikhan
Emerson Rosenberger: emmyrosen7
Simon: simon_romano
Natalie: natsch22
Nick Halderman: nick_halderman28
Josephine FG: josephinflangoodm
lydia schumann: lydiagschumann
S H A Y N A: shaynarichman
Zach Levin: zacharyllevin
Adams Saenz: adams.saenz
lucy flannery-goodman: lucyflannerygoodman
olivia: olivia.burgeson
: amrik_eastman
Jack Freeman: jack__freeman25
Adam Stievater: astievat1
hannah: imhannahschenk
mia: miashenkman
Jake Levy: jake_levy61
Jana Meltzer: janameltzer
Katie Carman: swim_mom22_
Philip Blumberg: philip.blumberg
Ketz Murray: ketzmurray
Gemma Friedman: gemma.friedman
Jane Andelman: janeandelman
Ellen Gilberg: ellengilberg
Trip Wellman: trip.wel
ben rosenthal: _brozy
Connor Kaetzel: kaetzelpretzel15
mackenzie kaczmarek: mackenzie.kaczmarek
jewel mootz: jewel.mootz
Molly: molly.kaufman
lauren neuman: lauren.neuman
Samantha Brady: samantha.brady31
Eddie Blumberg: eddie.blumberg
annebetz: annebetz26
emma koppelman: emma.koppelman
Sydney Gross: sydney_gr0ss
mando spando: mandibirnett
Amy Hartz Brown: amyhartzbrown
caro: caroline.burgeson
Brig Schmidt Gwyn: brignickgwyn
: samantha.foti
Jack Carman: jack_carman22
Olivia Grabman: ograbman
Sophie Andelman: sophieandelman
Kiersten Bergman: kierstne
Sardar Aqib Khan: sardar_aqib__khan
Tom Levy: tomlevy100
Doug Kaufman: dougk99
