Followers:

daphne: daphnewelter_
: chs_babydriver
Noah Shidlofsky: noah.shidlofsky
ADRII WITTE: adriiwitte
ry: ryan.brookss
: jnaidy_flicks
em: emilyc0hen
abbie: abbiegoldstein
hannah smith: hannah.smith1030
SIMBA: seansims_
Andie Aviv: andie.aviv
liv: livduncan1
MOLLY: _mollymoran
Est. May 2020: threader.co
savy :): savymking
Gavin Q Murphy: gavinqmurphy
maxi: maxi.grtn
katy hamilton: katyhamilton_
Skylher: skyyreyes
valentino: lucalovrich
REndevue: zaryzh
Shira Blazer: shira___blazer
Chad Kreshek: chad.kreshek
The Rosy Sisters: therosysisters
LEXI SIMSOVITS: lexisimsovits
dar dar: uhdarr
Dylan Dorfman: dylandorfman_
G I A: giaperel
CHS WATER ASSASSIN TIPS: chs.waterassassins.tips22
Aryana: aryana.gagas
taylor jackson: taylorbjacks
Yarden Madar: yardenmadarr
Ari Opolion: ariopolion
paige<3: paigepistotnik
Jordyn: jordynfeenberg
Sean Solley: sean__solley
Madison Serletic: madisonserletic
aly pardo: aly.pardo
Wisconsin Class of 2026: wiscoclass2026
KARIN HIETNER: karinxhietner
: fab.2175
Jordan Kingston: _jordan_kingston
venger: bellla.hope
Adi: adii._.a
challini: challini.dua
Sina: sina.vatoofy
Hannah Jordan: hannahtova
Jordan Norris: jordannorriss
alannah lomax: alannah_lu
Sam Sonnenberg: samsonnnenberg
Vincent Weisberg: vincentweisberg
: alexgesas
Jordan Collins: _jordan.collins
Daily Milwaukee Bucks: dailymilwaukeebucks
: ryan.kuchuk
Ben Goldstein: bengoldsteinn
Fariha Tadepalli: fariha134
: sadie.leighhh
Florence Mae <3: _florence_harrington_
Levi Kline: levibkline
Justin Nagel: justinnnagel
: ryanmattivi
: avryjustis
brooke: brookemorhar
Cooper Bowen: cbowen0817
Cade Miller: cademiller15
Kylie Kurzban: kyliekurzban
blake:)): blakegreenfieldd
Calabasas KYOTV: chskyotv
TruDine: trudineapp
Duke Deming: duke.deming
: _jakobgerber
i like cheese: harjap_mooks
Calabasas Decisions: chsdecisions2022_
lexi pendola: lexipendola
Bobby Buyalos: bobby.buyalos
Micah Kokin: micah.kokin
Ethan Erfanian: ethanerfanian
Alexis Sassounian: alexissassounian
Dara Namadchi: dara.namadchi
ADAM SCHWARTZ: adam.schwartz
Brandon: brandoniobbi
Jason Gravori: jason.gravori
Jordyn: jordynwaisfisz
tay: _taylorgerard_
collin: collin.gurian
maya <3: krutchie
Skylar McLaren: skylar___ashley
Get In The Groove DJ's: getinthegroovedjs
BROOKLYN KAYLA<3: brooke.bursteen
: _ethan.godsey
Julian: julian.f.taylor
The Calabasas Courier: calabasascourier
: aew.cutestet_couples6th_grade
ivy :): ivy.kriser
max: maxaaude
Max Karpel: hypestmusic
BUYING SHOES 24/7: supreme_li_
Kai Corben: kaicorben18
: thy_heem_bandit_
a: 420babyamber
Roy: royzaradez
ashton oppenheim: ashton.opp
: calabasas_lax
char: charrbinder
Adam Simon: adamsimon24
chloe: chloemendelsonn
Hili Levy: _hililevy
Ben Hendelman: benhendelman
Fabian Zignago: fabian_zignago
Zack Weisbond: zackweisbond
hayley: hayleyyslohnn
: emmaazad
Sterling: sterling.traznik
: blakesceramics
Leo Zaradez: leozaradez
Mattea: mattea_bilkiss
: kellyreubenn
: hankdufine
Corrine Kraut: corrine_kraut
Joseph Barkat: josephbarkat
misha: _misha.frolov
Jacob: jhrosoff
Helena D'Angelo: helenashepher
Maya Propper: maya_propper
Darius Tamaddon: darius_tamaddon
tyler ortega: tyler_ortega_
Ben Zaradez Realtor: benzaradezrealtor
: galibenn
: gigi.quynh
Gibby: gabekritzer
kate!: kate.ginzburg
dorothy: dorothyduzs
: greg.feller
Yuval Ohayon: yuval_ohayon
harlow ;P: harlow.jade
kayla: ka.yladione
Elnaz Shahid: elnazshahidd
Max Price: maxxpricee
emily!: emilyyyelbaum
: gabrielmarvin_
hud: hudsonserletic
abigail rose: abbeyhandel
Sebastian: sebastian__drake
C8: catesundahl
k!m!a: kimianematpour
Dylan Kiviat: dylankiviat_
Parsa Ghoreishi: parsaghoreishi
: lilyann.locke
Andrea Suchowiecky: andrea_sucho
Matthew Shapiro: matthewshapiro_
Keon Tehrani: keon_tehrani_
Jenny: jennifpaige
Leila: leilasach
Zach Grunewald: zacharryyyyyyy6
Omari: 0mari
petergray: peter.gray3
skyler: sky.hoff
chloe forssell: forssell
: edan.simon
Jasonmedrano: jason_medrano_
Nelly Jamneshan: nelly_jamneshan
: joshfeenberg
Drew Russ: follow_me_on_ig_drewrusss
charlie: charlieluciaa
Reya Brauer: reyabrauerr
: noahbennish
sarah: sarahdwiggins
Caden Palmer: cadentpalmer
romi<3: romi.tayeb
Sean Step: sean_step
danielle roseman: danielle_roseman
sofie: sofiegellman_
Dean Sclafani: deansclafani
drew russ: drewrusss
HAGS: hagsapp
emily pittman: emily.pittman
: adampriv123
Ella Moseska: ellamoseska
Ryan Tse: ryanrtse_
Aaron Schiff: aaron.schifff
Drew Martin: drewmart.in
: jonahstoney
Dorel Cohen: dorellcohennn
ally: allycooleyy
olivia: oliviafitzgeraldd
Kim Heyman: kimheyman
Erik Kritzer: erikkritzer
: nea.jones
Jamie Fairly: jamiefairly
Aiden Rubinstein: the_aidenrubinstein_
Adrian: adrian.darrow
Max Rivera: max_.rivera
Sam Ruda: samrudaa
: anacolovosss
ava: avamesghali
Carlos Lamont Palmer: _carlos3x
George: george_________6________
Yakir Aviv: yakir.aviv
: ethankang__
Fertoush: brandt.fields
Milan Mahserejian Macias: milan_macia
: saharrrasheed
Dominique’s.private: dominiques.private
Tate Steinberg: tatesteinbergg
brooke :): brooke.levitt
: miabengal
alec: alecroseman
Heather Lalo: heatherlalo
amy: amyyzzhao
dani <3: daniellarayy
: caseymarvin_
parinaz: parinaztoufighi
pierce: pierce.traznik
Jonathan: jonathannumaa
: natalie.kurtz
Ryan Gharib: ryanghari
Henry Solomon: henry___solomon
rachel rubin: rach.rubin
Jonathan Zvi: jonathan_zvi
Niko: nikomlobos
All College Lists: alllcollegelistsapp
alexandria reynaga: _alex.rey
: helenapichadze
Luke Chiate: lukewarmchiate
remi morris: remi.morris
Moses Miller: moseszmiller
MIKAYLA: mikayla.williamz
bre: bre.maldo
Dylan Meleo: dylanmeleo
allie: allie.elkins
ella: ellalandauu
Oskar Sarkar: _fedoraboy_
Eyal Rushinek: eyalrush
Dylan Kunert: dylan.kunert
: willxburgess
lily :): lily.greco
Canter Miller: canter_miller
Shayden Schorr: shayden.schorr
William Warshaw: will.3bg
ARIEL AMSALEM <3: arielxamsalem
Luke: luke_olshever
Justin Naidrich: justin_naidrich
: samgrunberg
J: jaidydaniella
Matt Tamura: matt_tamura
Chris Haren: chris.haren
olivia: livhaber
Ben Kurland: ben.kurland1
Nicholas Waley: nickwaley
TESS: tessdrosmann
Matthew: mapleleafsmatthew
: kate.mittin
EATS WITH LEX: eatswlex
Jaxon Clark: jaxonclark_
benjamin meppen: benmeppen
Ryan Yates: r.yates
: darius.motamedi
ava bowers: avaabowers
A i D A N ®: aidanrothman
Massimo Murphy: massimomurphyy
: deanjfrank
max: max.tannenbaum
: sophiakimmell
Ben Tene: ben.tene
Aaron Nachshoni: wallcovering_int
Tobey Bongar: tobeyb3
Mark Rusak: mark.rusak
Chs_fit_check: chs_fit_check
Mary: mary.georgilas
micaela: micaelafrancess
Nico Della Ripa: nico_della_ripa
Ryan: ryan_gilhuly
JESS: jessnaidrich
Sean Walker: sean_walkerr
Gabe Poura: gabe_poura
ben: bennitzan
: deagonkimball
kris: kristenlarsonn
Robbie: robbiewilder_
Evan: evan.caplan
Josh Zvi: joshua_zvi
Gavin Guenther: gavin.guenther_
Elliott Luftman: elliottluftman
Maddie: madisonchristl
Gael: _gaeldorado
Oran Shalev: oranshalev
phe :): pheonajade
Brandon Pink: brandonp1nk
Ryan: ryanazad_
taliah dayan: taliahdayan
phia: sophiaschalll
Jack Bussiere: jackbussi
Cooper Bobbitt: cooper.bobbitt
annie kopaloff: anniekopaloff
kiana asgariani: kianaasgarr
Ben: benevanfrank
Chloe Starr: chloereisnerr
Bailey: baileycampagna
Mazal Natan: mazalnatan
mai franco: maifranco__
Phoenix Call: phoenix_call
Adriana asf: cloutzai
Jordan Jaffe: jordnjaffe
Charlie: charliegklein
Paige Frazier: paige.frazier
Daniel: daniel.robbins
: josh.wordin
Jake East: jakeeast_
Nik Gerber: nikolasgerber
Cole Beeman: cole.beeman
: jakob.plutsky
Bree: bree_santa__cruz
carlie weiss: carlie.weiss
: shrishbhatia_
CAROLINE: caroline_loper
andra: andravincze
KATE: kate.mead
Dillon Thomas: yungseebs
: jeremryyy
Ela Trivedi: elatrivedi
Melinda Cooper-Polakoff: melindacooperpolakoff
Grace: grace.elkins
Kaden: kadencohan
isabella: isabellaasolis
ellie<3: elianaturobiner
Zach Sweet: zachsweett
Willow: willow.gav
: sophieazimi
Noy Ezra: noy_e2
Zac Rasnick: zac.rasnick
kylee jensen.: kyleemellick
a-samiraaaa: a_samira_abrisham
Ben Fairly: fairlybenjamin
Noa: noabenn
virginia-grace: vg_haase
abbie: abbiepeck
sam: samoleesky
Kayl: kaylfm1
: ari.manbun
Kai Tsoar: kaitsoar
: bradynebens
Aiden Della Ripa: aiden_della_ripa
jake: jakegonzalezzz
Gracey A: graceydriaa
sb: sarahhburgesss
nate dog: nathan_zimmer
Lauren Thai: laurenthai_
Ashwyn Bagga: ashwynbagga
Devin: devingasway
evan: evanrochee
val: valcaas
Tyler Shulman: shulman_tyler
Evan: evancaplann
mylie: myliemecham
DYLAN_BENHARASH: dylan_benharash
Maddie Stoner: __maddie__s__
Aika Takanashi: aikameili
EMMA GLASSER: emmaglasserrr
: thesahanadesert
SPEAR: spear_winery
Gina Cohen De Paiva: ginadepaiva
TY KEOUGH: tykeoughphoto
amy ross: amyyy_rosss
cool_coola: h.n_2017h
liv: oliiviacoe
Heidi.trr: heidi.trr
MARLEY SKYE: marley.reisner
Romy Lee Strimling: romystrimling
kay kay: kaylie.roche
Atish Gupta: tishyfishy22
mallory <3: mallory.ccooper
: aidensolovy
: jaden_zman
sophie dodd: sophied0dd
kylie: kylieheimlich
: calabasasfbmemes
Sam Kraut: shmuelsamkraut
Ari Marmorstein: arimarm_4
sofie: sofiekocar
4 friends Private: july20kb
sienna elle berman: siennaberman
Sam: sam_schro
LAINEY JAYNES: lainey.cook
el: ellie.mcmullen
adam: minkkow
camweitzman: camweitzman
Jordyn: jordyn.greenfield
Lesley Roby Marvin: xymagnet
Noga: n_o_g_u_h_h
Jake: jakebaum_
kathleen: kathleenshiffer
Chloe Rose: actress_love_life
emily: emilyylavinn
syd: sydneyy.weiss
Sahana Tadepalli: sahanat11
nicole: nicole.mazaheri
: jdrfawarenessclub
Milly: milly_roseman
hannah: hannah.nagell
amber: amberrpreston
nick: nickharlo.w
Greg Tamura: gregorytamura
: ellapolvy
Jake: jakegsamuel
: jaggercorey
Gaby: gabygoldberg_
Josh Tenenbaum: joshtenenbaum
audrey: audreyh0
Ryan Bullard: ryanbullardd
Kian: big.kian
Erel Naar: erelnaar
Josh Mechanick: josh_mechanick
Samantha Metken: samanthametken
CHS Career Club: chscareerclub
May Natan: maynatan195
lily polvy: lilithsprv
Courtney Rauchman: courtneyrauchman
CALABASAS TENNIS GIRLS: calabasastennischicks
: jonezy.newman
CHS TENNIS GIRLS: chstennischicks2.0
: gaybekritzer
Chase S.: chase_smith77
sammy g: sirvanillacream6903
Jonesy Newman: noodlezking
Sapir Ariel Russo: sapirrusso
jozy :): jozyparshall
hannah roth: hannahr0th
COLE STRUMPF: colestrumpf
Aren Kevakian: arenkevakian
Grant Goldstein: grantgoldsteinn
Tyler Bergman: tylerbergmannn
: parkerericson
JohnCañamar: ramanac_inc
jess :): jessicarosenblattt
Eli Waksman: eli.waksman
Nikolai Ladon: nikolai.ladon
Gabe Goldberg: gabe_goldberg
Ana Jones: anajones8963
nejla <3: nejlam__
Calabasas Athletics: calabasashsathletics
Kristine: kristinemariiee
nick ponsig !¡: nickponsig
Maddie: _maddiekirk_
gab: gabrielle.fallas
Nema: nycto_nema23
Antonio Marroquin: antoniomarroquin16
anonymous: aew.couples.official
Shay Boloor: shayboloor
: djicklespay
Tussa: ethan.nisenberg
gili: gilidatnerr
Chs Lacrosse: chsjvlax
: maxxweisner
Jacob Polakoff: _jacobs_backup_acc_
: adithesped
SCOPE Club at CHS: scopechs
lucaaaa: luca.lenders
Dadddddddddy: j_aaaacksonn
CHS FIGHT LEUKEMIA CLUB: chsfightleukemia
: a.c.swadling
Jackson Ratner: jacksonratner
Broncoz: erush62
Jake: jakeravoo
: ethan._.mccallion
Cole Beeman: cole_beeman
Jake Price: jake_price__
cole: cerealbowlcole
Haim Naar: haim_naar
Sam Kraut: samkraut321
Moran Duek Natan: morannatan
Dean Kantor: dean_kantor
Fariha Tadepalli: fariha351
ryan: gachis.1
kathleen: kathleenrobertsonn
Jung Hull -: junghull1__
HAGS: The Quad: hags.quad
: lakerz24_
Andrew Guinchard: andrewguinchard
i love u: unfollowthisstupidaccount6767
CHS Clubs & Community: chsclubsandcommunity
Calabasas Lacrosse: chs_lax
Growing Minds AAC: growingminds_aac
: wiscoclassof26
: pipeeeitupppp
Mara: maramirkin
Jillian Bassett: jillianbassett_
: a.ewrightcouples
nickravo: nickrav0
Trevor Owens: trev.owens
CHS Save a Child’s Heart Club: chssaveachildsheart
: aiden.goldey
Evan Papel: evanpapel
Marley Jo: marmar.jo23
DMAN: dmitree_bar
: pnut_k
DualPurposeHike_CHS: dualpurposehike_chs
shane: sshanejacobs
: davidginsberg_ig
sab <3: sabrina.ssmith
Biggest Saints Fan: biggest_saints__fan_ever
Cameron Papir: cameronpapir
Nick Zeto: nickzeto
: piperdobsonn
: kushaalt
Cassandra Miller: cassandramiller
Greg Heyman: gregheyman
Leyamae Hardaway: leyamae.hardaway
SAVE US: chs.saveus
Teresa Agnew: teresaagnew
Gianfranco: gianfrancos_backup_account
: superclippers
Ben Zaradez: benzaradez
Hei hei: lifebalance209
Tara: taramarghzar
Julia Mamelak: juliamamelak
Matthew Winner: mjwinner1
: dylanlondon_
Sam Malekzadeh: sam.malekzadeh
Since 1994: supreme_leaks_orangecounty
Mayli105: maya.brener12345
Sivan Assulin Fadlon: sivan_s.f
CHS Multicultural & Inclusion: chs.multicultural
: alygator128
: steven_roseman
Sivan Pesso is my best friend: danny_fanny_granny_
Aidan Berman: abx8s
Supreme: supreme_calabasas
: yo__mama12333
Dylan: dylkiviat_priv
olivia <3: oliviaammaxwell
CADE | Workout tips/trainer: fitwcade
Nate mor: natemmor
Maddie: maddie.mcquaid
Care 4 Cancer: care4cancerrr
SapirR: sapirrusso101
frnxcine: moirafrnxcine
GenUN Calabasas Chapter: genuncalabasashighschool
: flammindice
Peanutty: peanutty_k
Julia: julia.finch
Rozi Russo Reznik: rozirusso
Jayschwa Old Account: follow.jayschwaaa
Cole: frostiehype
: isabella.fercioni
Zach: zach.rubinstein
Marley Schwartz: marleyschwartz
Ethan: ethanguinchard
David Tanner Rosenthal: davidtannerrosenthal
Lawrence Lawrence: its.lawrence16
: hungry4acorns
Sam: sam_kraut
g a b y r u b i n o: gaby.rubino
hi: _black.screeen_
Clayton Green: clayton.green26
: someone_u_probably_know1
Zz Clark: zzballer04
knicks.news™: knicks.news__
William Shakespeare: life.as.shakespeare
: tony_23411
: chs2022bitches
: lilvodka
Preston: lil_roons
: smokepurppppppp_
Hannah_zein: hannah_zein
WATERisLIFE Club at CHS!: chswaterislife
Keith: jkoehinth
mememamba: mememamba69
: shayamccord
heidi rose RICKETTS: heidi.rr
Panthers Fan Page: carolinapanthers136
: senor_oogway33
soraya alai: sorrayaalaii
Lion Mountainlion: leonemontelione
Shelley Weinrod Roseman: shelleyroseman
ASB FORMAL: chsformal
Gt100: gtt_818
: a.ewrightcouples_
: calabasascrips
Whats Good?//DGCU: micaiah.private
Basketball Photos: basketb_photos
olivia: livbreck
: joey.troesken
Hags: calabasashigh.hags
Humza.Zaki: humza.zaki
Cccc: nitrwak123
: alexarivaaa
Ae Wright Couples: aew_couples2
Sports Designz: dopedesignz_
Execlub: ilovepets.exe
MemeMan: mememandem
FortnutMemes2019: fortnutememes2019
: therealswervonick
Skoot Clan: skoot.skoot.memes
: ki.anbo.lo
: ih_ohvlvj
: forthefansclothing
Project Panel CHS: projectpanelchs
: 228imsport
Jessica: soyjessica1
: _thedaner
: dhhdhdhdhdbdb
yuval menahem: yuval_menahem98
xxxxxxx: notanaccount111111111222222
: deletedacc172737
Yogi: nonohhbbbb
Joe: jaquay_i_like_
: the365success
: krystalharrisss
shoutoutx365: shoutoutx365
keysha raynisha III: keysharaynisha
: veahhh_2rawww
: djdjsjjsjsjsjjsjz
