Elizabeth Reckling: elizabeth_reckling
Christina Oliver: christina.oliverr
caroline: golf_hsu
Peyton Young: peytonyoung41
William Mitchell: william_mitch11
marisa: _mboue10_
irene capitano: ireneslikeschipotle
Jennifer Stedman Haynes: jhjhaynes
Ashley Morgan Hanna: ashmhanna
Adelaide: adelaide.dooley
caroline: caro_buckner
ediff: eleanorxsse
Grace Vallone: gracevallone
Matthew Moseley: moseley_matthew
Adam Behr: adamtbehr
Juliet Emily: catgirl_juliet
Canaan Estes: canaan.estes
Jared Orkin: jared.orkin
rivers breeding: riversbreeding
Jen Thornton: jenthornton2503
Amy Greenwood Hemingway: amyghemingway
penelope: penelopegustafsonn
katie: katie.wasserman
Katie Whiteley: katiee_.whiteley
Daniel Miner: daniel_miner_
Caroline Kubitza: carolinekubitza
Jane Dees Shepperd: jane__austin
Maddy Billipp: maddybillipp
Ed Harris: edh0053
Augie Piczak: augiep1
Eric Wang: ericwang360
Laura Rocha: lmr1999
ELLA DUCHARME: ecduch
Lily MacMane: lilymacmane
Ava: _hunny.bunny_
Joslyn Paris: joslynparis
Maya Buryakovsky Pomroy: maya_b_pomroy
Alexandra Tropoli: alexandratropoli
grace markovich: graceamarkovich
Sahasra Thakkar: sahasrathakkar
Michele: _michelehoward
Davis Towns: towns.davis
Michelle Sekili: michelle.sekili
Natalie Josephson: nat.josephson
Watt Muir: wattmuir
Vivian Rose: vivian.f27
Aparna Balachandran: balachandranaparna
caroline swanson !!: carolineswans_
Walker Brown: walker.brown
ray: ray.t_0
Henry Hawthorn: 9henryhawthorn9
molly dinerstein: mollydinerstein
Caroline Thames: thames.caroline
Travis Ainsworth: travi_boi99
Grant Smith: grantito06
Stephanie Perkins: stephieperk
MASON THENOR: mason.thenor
Kallie Carlson: kalliecarlson2022
Bradyn Robertson: bradyn.r1
Trace St. Julian: trace.stj
Ryan Karkowsky: ryankarkowsky
Toni Arkless: tonilynne02
Emeline Moss: eme.moss
mary eloise: maryeloise.searls
Lori Julian Jazaeri: lorijazaeri
Alexander Farahbod: alexander.farahbod3
Lindi Ruthven: lindi_ruthven
Teddy curry: thc_517
Mimi: mimi.iglesias
NGK: lil_general98
William Klaasmeyer: williamklaasmeyer
Karen Li: karenli8765
Kristi Kay Estes: elemhen5
Avery Smart: averysmart
Soraya Patterson: sriracha2022
Michael Hay: michael.hayyy
Isabelle Grace: isabellevgrace
Patrick Reilly: patrick.reilly27
reese ham: reese_ham
Sam: sam.fowler10
Caleb Pitts: calebpitts20
Beth Robison: bethsrobison
john cenas dirty cumslut: dreamy.love.mcyt
Sammy Riesgo-Zamudio: sammichrz
Kelly Webb Sklar: kellywsklar
vanezamudio: vanezamudio
weiwei: weiweii_zhang
Justin Ganim: justinganim
Brian Chen: bchen76
charlotte stokes: charstokes_
Lauren McMackin: lauren_mcmackin
TALI KALMANS: talikalmans
marykate: marykate.cornett
Savannah: savannahgmiller
Ryan Jinnette: ryan_jinnette
Brady Lamme: blamme32
prescott lau: bikeracer9
Olivia Fowler: olivia.fowler11
Karen Treistman Susman: ktsusman
emily camp: emilly.camp
Jill Deutser: jill_d4
Lauren Marangell: magneticdoc
Marlo Bruce: marloelise
Ian Overman: ian.overman
Rikke Burke Graber: rikkegraber
Justin Li: justin.__.li
Kyle Smith: kylesm.ith
Suzanne Gerum Stiles: suzannestiles
Laurie Bieber: biebshouston
Taylor: taylornis14
Nancy DeWalch: nancydewalch
Tracy Dillee McCleary: tdilleemccleary
Carrie Paulus Vallone: carrie.vallone
Fawn Phuong Doan: fawndoan3_
ashlyn gilhooley: ashlyn_gilhooley
Stockton Lord: stockton_lord
mary blake williams: maryblakewilliams
Will Pielop: will_p736
Finley Colvin: finleycolvin_
Noah Rubinson: noah_rubinson
Kate Robison: _katerobison
Bryce Pollock: brycepollock_
LM Patterson: lmpatterson6
Laura Hulsey Kelsey: lala.kelsey
: jlcny
Amanda Gonzalez: amandab_gonzalez
Jc Al-Uqdah: jclifelove
Amy: hellotexas
Andres Bustos: abustos233
Kristen Mullen McMackin: kristenmcmackin
ainsley: ainsleypowers
Vedul Palavajjhala: vedulp
Leslie Bleil Cornett: lesliecornettmiddleton
Alexander Miles: _alexander.miles
Courtney Mitchell: ctmitchell00
jordan roberts: jordannrobertss
Soha: sohasewani
Susan Le: susan.h.le
Shreya Mehta: shreya_m12
Peter Jackson: peter_frosty
Camille Andrews: camilleandrewss
Sarah Grace: sarahgraceraynes
E L L I E: ellie.cockrell
Laura Citardi: lauracitardi
Sophie Girard: sophietgirard
Jeanne Moses: jeanne_moses
Julianne Bremer Kugle: jbkugle
Gracie Mitschke: graciemitschke
Charlie Kugle: ckugle03
Leisa Ladin Dillon: leisald
Carin Brody Davidson Collins: carinsta_collins
Bennett Mach: machbennett
Ana Zamarripa-Hicks: johjohmom
alison: alison.j.zhang
Allison yang: allisony_ng
Blanca V Gonzalez: blanca_vg8
Jack Lemon: jackdlemon
Braeden Arkless: braedenarkless
Patrick Solcher: patrick.solcher
Matthew Berman: mberman2006
Mercer Peakes: mercerpeakes
Sarah Tropoli: sarahtropoli
Nicholas Dillon: nicholasmdillon
lee :): lee_stallings
Humza yousuf: humzayousuf97
: charlie_sole
Kee Shaper: kwshaper
Audrey Russell: aud.rus
Elizabeth: eoxpagan
Garrett Hankamer: garretthankamer
amy lee: aehl_73
Anna Duarte: anna.k.duarte
Miles Masterson: miles_masterson
JoJo <3: _j.cas.tro_
Ashley Dierker Klaasmeyer: ashleyklaasmeyer
Elise Reckling: elise_reckling
Pryce Pivec: ppivec7
Katherine Rush: kitkatrush
Ryan Horlock: ryanhorlock
Kenneth Jett: kenneth.jett.9
Evan Wu: evan.18w
Walker Ball: walk_ball
Anthony Gonzalez: anthonyngonzalez_
Luis Graham: luisgraham19
Shelley: shelleysorkin
Paige Dominey: pbdtexas
Grace: gracebeilstein_
Kristen Weber: kristenweber5
Nicole Nathan Gibson: nicnatgib
Traci Clay: traciclaymccoy
Catherine Gordon: catherineegordon
Mary Catherine Sharman: mcsears12679
Lewis Kalmans: sweetlewkal
Suraj Pandit: sj_pandit1
ellen hogan: _ellenhogan
: kml_1028
Avery Thompson: averyt3
Maddie Juarez: maddie.juarez
camille weber: ccamilleweber
: lauragaylescott
kelly: kellygilhooley
libbyliuzzi: libbyliuzzi
Johnny: johnny_walters08
Amruth Nandish: amruth.nandish
Jennifer Scheifley Roberts: jscheifley
: ruby0608
Tracy McMullen: mcmullen_tracy
Allison Lewitton: allisonlewitton
Miranda: mirandali_
Lauren Suttle: laur.sutt
eva humble: _evahumble
: allyn.songg
katie quander: qatiekuander
Patricia Lynn: patriciallynn
Sandy Selber Sturm: sandyssturm
Bakin: bryanakinn
Lesley Johnson: lesleyjohnson1222
James: james13_____
Stewart Jones: stewhjones
Greta: greta_prieto_
Kennedi Poullard: kennedi.poullard
susan e meyer: susanemeyer3
: foster_stephens
Ellie Bullard Skelton: elliebskelton
Maddie Guyton: m.guyton
Mia Price: miaprice__
Lacy Howe Rieke: riekemail
Haania: haaniapunjwani
Shaan Dhutia: shaan.likes.to.yawn
Sonia Zhang: ssoniazhang
Oliver Eades: ome.05
Lily Claire: lilyclaire_alpert
Cole Hartung: c_har_993
Connor Blake: luxpermathematicam
elise shu: eliseeshuu
Nada Zakhour-Honjo: honjo_ned
Heidi Moryl Roeder: heidiroeder
Charlotte Sullivan: charlotte_sullivan18
Christie McCartney: cmccartney96
Odin Hicks: odinhicks
: karoline1973
Brooke Martin: broookemartiin
Kristin MacMane: special_k_mac
Harrison Hester: harrisonhester1
Lindsay Nussbaum: lindsaynussbaum_tutoring
Connor Dawson: connordawsonn
Carolyn Lobb: cmlobb
Niaz Siamak Lighvani MD: momidoc
Claire Wexler: clairewexler_
Harrison Jones: harrizola
Arsalan Saeed: arsalans1113
Raquel Segal: raquelsegaltx
: momnockolds
Paysan Lau: paysan_lau
Arden Fayard: ardenfayard
Alex Nigro: alexnigro
John Vallone: john.vallone
Amy Seigle: flockaseigles
Eliza Mitchell: eliza_mitchell11
: _natalieou_
Courtney Taylor: court_taylor99
Emily Brennig: emilybrennig
Erika Benz: eribenz
Chandler Black: _chandlerblack
helen: helenwexy
gabriel xu: gabexu06
Tanner McNamara: tannermcnamara
Kim Hankamer: khankamer
Lacy Rush: lacyrush8
Staci Watson: staci.watson1
May Moorefield: may.moorefield
Wendy Blanchard Hall: wendy.b.hall
Matt Munn: mattmunny
Nick Bhasin: nick.bhasin2
Chloe Childress: chloemchildress
Cole: cole.nockolds
Jennifer Brown: jennwbrown4
Joanne Wilson Margraves: joannemargraves
Charlie Christ: charlie.christ
Stefanie Trachtenberg: stefanietrachtenberg
Max Roeder: max.rodrr
: chloehbwilson
Barb Fowler: fowler.barb
Martha Kendall: marthamacmane
L Shaper: lshaper
Suganya Mani: suganya_mani
RMP: rinapresleyy
Stacey White: shkwhite
Caroline Schillaci: caroline.schillaci
Mollie Gordon: dr_mollie_gordon
iz :)): izzyyhendricks
: saween.thompson
Kendall Howes: kendalll.howes
SANA: ghauri_sana
Emmy: emmy.stubbs
KYLA: _kylahenderson
Shayne Newell: shaynenewell
Hayden Lewitton: haydenlewitton
A l l i s o n W i s e: allisonbwise
Waverly: waverly_peakes
: isabellagoytia
Felicia Cweren Lewin: lewin9609
Courtney Tsao: courtneytsao
Betsy Hirshfeld: behirshfeld
Annette Boatwright: annetteboatie
Duncan Lambert: duncan.lambert
Claudia Ward Holmes: claudia3015
Tanner Nyveen: tannernyveen
Jessica Brazelton: jessica_brazelton
Luis Graham: luis_grahamm
kathleen_colt: kathleen_colt4608
Kara Montgomery: karasitam
Ed Bialas: edbialas
Teagarden Family: teagardenfamily
Lexie Rose: lexielehne
Kelli Bish Little: kblittle28
Greta: margruss16
Becky Walker: beckygwalker
Evan Chambers: echambers_
Jean Beach: beachjm
Anne Smith: anne.t.smith
Tyler: tyler_winter1
Kyle Kekish: kylekekish
Mary Nell Boone Suell: marynellsuell
Max: mightymax5119
Daniel Leibman: daniel_leibman
LT Cameron: ltcameron1
CTLD: tmcl0223
Kate Searls: treen0513
Ashley Copeland Loeffler: ashleyloeffler
: maemontgomeryy
Robert McNamara: robertmc2019
Lia Bonet: lia.bonet
claire: claire.ehart
Ian K: ianlkim
elisabeth bell: elisabeth.bell_
Connor Doan: donnorcoan
Melissa Bloome: melissabloome
Ava Malonson: avamalonson
Allie Cox: alexandra.cox
Anna Ferber: anna.ferberr
Joella Mach: joellamach
Elizabeth: elizabeth_landrith
: wiglesias6130
Preity Bhagia: preityb
: iamamechi
Adrienne Murphrey: amurphrey
Richie Raclaw: rraclaw20
: _leriley_
katherine zhang: kat.zhang23
Shelby Nielsen: galvestondandy
Cari griggs: cari.griggs
Jacqui Kneese: kneesejax
Kyle Massey: kylemassey_
Nate Vutpakdi: nate.vutpakdi
Stacy: sajinnette
Lynne Hay: lynnehay
Larsen Weber: larsenweberr
Melissa Dewees Smith: mkdsmith02
Lexy Pakzaban: lexypakzaban
Farrell Harris Saunders: farrellsaunders
army ka divana: army_love.s_ak47
Kristen Madison: kristenmadison
Christine Rose Laskin: claskin
Cindy Garza Priest: cindydgarza
jordan finkelstein <3: jordanfinkelstein
Jeff Malonson: jeffmalonson
Lauren Morgan: lauren_r_morgan
Thomas Carr: _thomascarr
: kristenkbuck
Collin Dawson: collin_dawson04
Trish McIntyre Whitcomb: tmacwhitty
Deirdre Carr: deirdremcarr
Quenby Jackson Mott: quenbyjmott
Cameron Ederle: cameronederle
Jen Gray Moss: jkgmoss
Eleni Fuller: elenif11
hope morenz!!: hopemorenz20
Gardner Watson: gardner.watson
Katie Bel O'Donnell: katie.b.odonnell
Talan Tellepsen: 20talan_tell06
ALICE: alicetma
Caroline: caroline.colt1
Walker Marrus: walker.marrus
Stephanie Ward Ball: ktephball
Erin Williams Heath: erinwheath
Lili Lassoued: lililassoued
Parker Kubitza: parkerkubitza
Jill Josephson: jilljosey
Laura Chiles: lauracchiles
elisabeth marek: elisabethmmarek
Maddie Harrell: maddieharrelll
LINDSEY KARKOWSKY: lindseykarkowsky
Rob Morrell: rrm.i
Grace Hao: graceyhao
Olivia Sullivan: oliviatsullivan
K8 HYMAN!: kate.hyman
nikita: nikitanaut1yal
Anne White: anne.e.c.white
Gillian Huston: gillybean2212
Katy Krips Nelson: katyknelson
Lana Lee Cureton: lanaleecureton
Olivia Howard: oliviahowardd
CRHS Senior Class of 2022: cyranchseniors22
April McMayon: aprilmcmayon
Jennifer Pye Cox: jenniferpcox
Samuel Sloan Colt (the third): sscolt3
Henry: henry_durning
j: jordanelysethomas
Tracey Hull: traceyshull
Deborah V. Brown: dvbrown76
Jake Campbell: jake_campbell_1
ryan call: ryan.p.call
Preston Herleth: preston_herleth
Pacey Ham: paceys_creek
Ali Yousuf: ali_yousuf_22
: krisdgun
Mindy Moak: mindymoak
Sophia Martin: sassysophsoph
Ruth Nichols Stubbs: ruthannstubbs
Haiyan Yu: haiyan._.yu
Annabel Skubisz: annabelskubisz
Suzanne Balchunas Boué: suzanneb4
Britney Tran: britneytran
Cooper Russell: cooperrussell_
Sutton: suttonbartlett
Frances Limoncelli: flimstagram
Lenora Stubbs: lenorastubbs
Will Gordon: _willgordon
:))))): eliana_estes
Tyler Lewitton: tyler_lewitton
Patrick Fanning: pfanning17
Arnold Bahati: bahatiarnold
lauren b: laurenn_elizabetthh
J King: jsek1976
Shelley Iglesias: siglesias2366
Jenifer Ben-Shoshan: jenbensho
Eliza Segal: elizasegal3
: trash.boat75
Braveladybug: braveladybug2014
Kaitlin Keene: kaitlin_keene
Dan Gilbane Jr.: dan.gilbane
Lauren Shu: _laurenshu
: morese2
Virginia Murchison: virginiamurchison
: tgottsegen
Alice: aliceahuero
morgan jackson dewhurst: morgandewhurst
Brooke Sharpe: brookiemsharpe
Dawn Ann Swanson: dawnannswanson
Laura Fanning: laura.fanning
Cate Soriero: catesoriero
Kim Conrad: kimconrad72
Leslie Cline: lesliecline1
Serena: serenathompson_
Anne Edwards: agbedwards
Deneige Soileau Dooley: deneige.dooley
klarissa: klarissa_diaz1
Laura Newman Ruthven: laura_newman_ruthven
: lmsmalll
Read Liuzzi: readliuzzi
Pierce Morrell: pierce_morrell
Susan Cox: susan.h.cox
GP: graceperrin_
Jacob Newell: kfalco22
Kelley Young: kelleycyoung
Missy Pitts: missyflpitts
Shana Pounds Burrow: shanaburrow
Ava.: _avawinn
ML: marylacyrieke
: lockestanton
Haley McClan: haley.mcclan
Sheri McIntire Bailey: sherimcintirebailey
Matthew Godinich: mgodinich
Henry Segal: henry.segal
Carter Kelsey: carterbkelsey
Mindy Rice: mindyrice1
Cullen Grant: _cullen.g_
Brooke Jackson: brookesjackson
Marion Fertitta: marionfertitta
LOUISA YOUTT: louisa_youtt
Maria Yousuf: simple_gourmet_meals
Laura Landers Cureton: lacureton
Sarah Anne: sarahannesnoots
Jazmyn Williams: jaz.myn_21
Sydney Smith: smith.sydney05
Anissa Crumley Paddock: acpaddock
gia!!: giannnna.c
Amit Lahoti: amitlahoti005
E Whitaker: ellingtonwhitaker
Jennifer Stevenson: jenni.stevenson1
Maya Bajwa: wan_der_ful
Luba Bigman: lubabigman
: alex_lassoued
T Riley: 13triley13
Jennifer Haikin Zach: jenniferhzach
Sharon Lesniak: sqlesniak
Cui Tao: taocui66
Clayton Rice: _claytonrice
Jennifer Pardoe Gilliam: jenniferpgilliam
Chris Kugle: chriskugle
Gina Muehr Lamme: ginalamme
Deb Young: tolexma
Kamsi Ndee: kamsindee
Erin Walsh: erin_walshh
Camille Cromwell Scott: camillescott6
Cade B: cade_brown7
Oliver Oldham: oliver__oldham
Tiffany Herleth: therleth
: eva_wolfe
Haresh Yalamanchili: hyhtx
Karen: karenbaerenstecher
Maria: myousuf1977
Jaisal Kalapatapu: jaisal.kalapatapu
Angela Wainright: angelawainright
April Abello: abello1010
Brooke Jacobe: brookejacobe
Tee Wickman: teewick
blakely brown: blakelybrownn
Nick Neblett: nickneblett
Scott Altsuler: scott_altsuler
: cam11henry
John Klosek: klosekjohn
Jack Bray: _jackbray_
Dee Dee Guggenheim Howes: d2howes
Susan: sheldebrand
Janie Slocum: janeanneslocum
Charlotte Shively: charlotteshively_
Sarah Cooper: scoop881
Ally Jafarnia: allyfpj
Katy M.: katyfminer
John Klevenhagen: johnklevenhagen
Matthew Childress: instathew
Shannon Hardie: shannon_leigh_hardie
Payton Daly: paytonraydaly
Kelli Weinzierl: kellwein
Elizabeth Moore Elder: emoore4u
KatieBrassy: katiebrassy
Tina Papandreou: tina.papandreou
Elizabeth Eades: el.izabeth5588
Ladin Strauss: ladinstrauss
Dylan Keller: _dylankeller
Kenan Oldham: kenanoldham
Leslie Margolis: leslie.margolis.1
Olivia-Kate Stephens: oliviakatestephens
Katie Pipkin: pipkinkatie
Carmen Mach: carmenmach
Dameron Baird: mamabaird3
Heidi Hill: hillhhh
AUDREY BROWN: audr3ybrown
Shannon Blake: shannonblake35
Kathryn Adkins: km.adkins
Danielle Monticone Schmulen: danielle_schmulen
Avery Brazelton: avery_brazelton
.: essteebann
Anastasia Marshall: amarsh1975
Tatum Cox: tatumcox1
Aicha Limayem: aichal
Valerie Vance Locher: momlocher
emilymcg4: emilymcg4
Sydney Newcomer: sydney_newcomer
suz: susie.girard
Pete Cureton: petecureton
Jared Laskin: jared.laskin
Jack Klosek: jackklosek
Connor Heath: cbheath5
Brooke Maddox: brooke__maddoxx
Meredith Huston: meredithlamehuston
Marie Louise Kinder: kindermarielouise
Carolyn Clancy: cclancy3
Blake Williams: ablakewms
Jill Holstead: jmhoddie1
isabelle davenport: izzydavenport_
Wendie Childress: wendiechildress
: crmorenz
Elizabeth Hogan: elizabethlhogan
Caroline Mitchell: carolinemitchell2821
Charlie Pagan: cpagan.18
Evan Bailard: evanbailard
Mary Sommers Pyne: mspyne
K8 Farmer: katefarmr
Maddie Holley: maddieholleyy
Daryn Mehling: darynmehling
Melissa Milton Knauth: mknauth1
Skyler Swanson: skylerswan
Elena Loya: elenaloya3
Erin Goldman: txerin12
: jason.boue
Lindsay Nussbaum Levin: lindsaynussbaumlevin
Abigail Klinkerman: daklinksta
: cubbymoore
Audrey Lobb: audreylobb
João Dubern: joaosxm
Hudson Gage: hhudsongage
Suzannah Gilmartin: suzgilmartin
Rebecca Gandolfi Gottsegen: bgottsegen
: kinkaid_boys_soccer
Matthew J Rush: drmrush
Amy Nanna: amyenanna
Kate Mitchell: kateemitchelll
Christina: ccvanos
camille: camillewatsonn
: blakewinburne
HRH9: hrks9
Christine Williams: cbwilliams
Greta Ravitsky Pliskin: gpliskin
Mia Abello: mia_abello
Monica: mon_hampton
Yan Li: sdyanli
Ben Shaper: ben_shaper
Texas | Kinkaid: robbytaylor_
Michael: michaelakin_
Stephanie Cockrell: sacockrell
Jennifer Andrews Moore: jennamoore19
Megan Buzbee: meganbuzbee
Tom Van Arsdel: tvanarsdel
Eslam M.Abd El_salam: eslamabdelsalam207
daniela: danicontrerasojeda
Onuchi Ndee: nuchndee
Stacy Hardison: stacyhardison
Susan Cannon: susancannon3211
Michael Hardison: hardison6595
Jose A Narbona: josenarbona21
The Motion Picture Club: themotionpictureclub
Courtney Hutcheson: courtneyhhutcheson
Dylan Marcus: dylansmarcus_
Dee Muir: deebmuir
Yannis: johnnyhouse1
Kate: katedewalch
Kinkaid Seniors 2023: kinkaidseniors2023
Chantae Higginbotham: chantaehigg
Ammar Ali: ammar_ali345
Lauren Moak: laurenmoak_
Clay C: clay.m.cameron
Doug Bauer: doug.bauer
Luke Weinzierl: luke_weinzierl_
Sarah Swanson: sarahswanson13
Abbie-Louise Lord: abbielouiselord
: honu2005
Alix Smoots: judgealix
: kinkaidseniors2024
Emi: emialvmel
Mary Katherine: mk.rice
Marlee Sikes: marleesikes
Katie Graham: katiee__graham
: amandadavis75
Amy Goldberg: amy.goldberg.10
Jennifer Stryker St Julian: jenstjul
Kayla: kaylasdavidson
Lincoln Colter: lincoln_colter
dev: devyn.finkelstein
Scott Lambert: slamsashcan
Maddie Christ: madelinechrist
Teri Gordon: teriggordon
AP: aphrodite.papa
EMILIA: emiliaalam
Ana Sofía Miró: anasofia.miro
ceceliaoconnell: ceceliaoconnell
Truett Akin: truettakin
Care Package Queens: carepackagequeens
Yara Karam: yara.karamm
: walker_bruce2
: alexgottsegen
Spenser Wood: wpensersood
Sophia Neylon: sgneylon
Kinkaid Falcons Field Hockey: kinkaid_field_hockey
Denise Horowitz: horowitzdenise
Jackson Doran: jackson_doran_99
Thomas Chen: thomchens
emma: emmahurley4
Will Swanson: will.swanson13
Gavin Johnson: gavin_johnson_22
Jennifer Pearce Gatto: jenlovenyc
Macie: macieehenderson
Araceli Graham: aragraham
Lila Griggs: lilagriggs
Douglas Bauer: douglas_bauer
Alex Villamil: avillamill
Brittany: brittanyecousins
JBJunell: jjwhat106
caroline girard: carolinegirardd
Skye Perkins: skyeperkins_
racquel: rocky.mccauley
B :): bennettjonesss
Frances Compton Rambo: rambofrances
Michael Josephson: michael.josephson
Doug Swanson: dougswan1
Lauren Hankamer: laurenhankamer
Richie Klosek: richieklosek
b l a k e l y b r u c e: blakelyebruce
Dawn Christopherson Powers: iluvdietcokewithlime
: tcguyton
Lizzie Yzaguirre: elizabeth_yzaguirre
Armaan Talabi: armaantalabi
katie toney wynn: katietwynn
Lauren Tanner: lauren_tanner99
John Young: youngjr523
Dana Malone McNamara: danammcnamara
Donya Davis: donyarhea
: tamchek1
Jessica Hawkes: bigcityhawkes
ELLIE MORROW: ellieemorrow
Carolina Prieto Malonson: caromalonson
Vivian: liminvivian
lexie rose strauss: lexieroseee
madison price: madisonprice595
Jacqueline L: jacquelinelandrith
Kristen Duerbig Katz: kriskatz8
Louis Gustafson: louis.gustafson
Jeffrey Jacobe: jeffrey_jacobe
Genevieve: gsc_554
: tamaklosek
: michaelkoldham
Robin Riehl: robinvella85
Caroline Snider: caroline_snider
Elva Akin: elvaakin
Thomas: ttthomas2023
Natalie Harrison: natalieharrison1764
Caroline Dannenbaum: cdannenbaum
Jason Ahuero: jasonahuero
LD: laureldavis
Janet G.: janetg3030
Jillian Griffiths: jillian_griffiths_
Kelly: sollunaeestrellas
Morgan Le: morgan.le
G Roeth: g.roeth
MG: mollygottsegen
Eron W Grant: eron.grant
: kmart1971
Jason Consoli: consoli3dad
Chris Butler: chrisbutler4332
Talley Kirkwood: talley.kirkwood
Amy Goldstein: lulugoldstein
elizabeth scott: elizabeth.scottt
: courtneymagelssen
arusha: arusha_101
: neimanmarcusmimi
Jennifer: jfernelius70
: kabuettgen
Brady Edwards: bradysedwards
Andy Guy: andy11guy
Isabella Dawley: belladawley
Ruby Duncan: justrubes
I am Sam: samshiverick
Jennifer Colter: jencolter
Kara Kinder Vidal: uk4leaf
Kelly Geis Provine: kelly.provine
Rashaad James: rashaad.james
: blake.k.johnson
Liesl Helms Leman: liesl.leman
Lucy Knauth: lucyknauth
BaDaBOOM BALLOON: badaboomballoon
Rachel Hadcock: rhadcock
: carrielouise__
Fiona Watson: fionawatsonn
: malonsonjeff
Rana: ranaghauri95
Class of 2022: highlandpark2022
Taylor Bass: tayloralainebass
Laura Mayer Cyprow: cyprowlm
BKP: bpivect32
: byrdqueen
Chinaza Ndee: versachi575
Lakeisha Branch (aurora0987): aurora0987
Melissa Standley: mrstand2000
Piper Edwards: piper.edwards
Amy: amykrasner
Kinkaid SDLB: kinkaidsdlb
Tammy Wadsworth Brennig: tbrennig
Alessio Del Castillo: al_castle03
AJS: seae7e
lezamudio: lezamudio
Martha House: marthahouse8
Jenny Howell: jhowell216
Jason Consoli: jasonconsoli
: bwsolcher6126
alexandra watson: alexandra.watson1
Strake Jesuit 2022 Seniors: sjseniors.2022
: tjcarlson4
Jlu: jenny.lu.39982
McMayon: mcmayonhouse
: azzhole0527
Lamar HS Senior Class of 2022: lamarseniors22
Alkinder: alkinder20
: manyadl
Pawan Ji Akela: pawanjiakela
Reagan Bauer: orreagano
jordan grace: jordan.murphrey
The Kinkaid Middle School: kinkaidmiddleschool
Traci Young: tracitex
Aimee Baggett Snoots: aimee_snoots
lynn: lteler
Alexandra Knight: alexandraknight
aliblake: aliblake
Jack Randall: rackjandall
At-Home Tutoring Services: athometutoringservices
: mclhouston
Margie Sanders: gritagrande
SJS Class of 2022 Seniors: sjs.seniors22
Houstoncher: houstoncher
caroline nelson: caroline___nelson
Jessica Beinart: jessbeinart
Clqtinter: clqtint
River Oaks Baptist School: robshouston
The Kinkaidian Yearbook: thekinkaidian2022
Feelin ‘22: episcopalseniors
The Houston Epicure: allisonelisedas
nlcw8: nlcw8
Celebrating the seniors ‘22: memorialseniors2022
Daisy J: jdaisy9497
: ialfoc
KinkaidArts: kinkaidarts
Laura Davis: ladavis685
Kscholastic Inc.: kscholasticinc
Marcia W. Smart: smartinthekitchen
Kinkaid Lower School: kinkaidls
Liz Smith: heygurl.1418
Suzanne Russell: suzanneeruss
sahjaythakur43: sahjaythakur45
: _amisc
: charl1ie.finsta
Laura Thomas: bukagoda
Lauren Burke: laurenbyerburke
Jennifer Pye Cox: jennifer.pyecox_compass
Cuddles: fatcat_houston
