william: thebillymcnamara
sharki star: sharkistar
Emily Wilkinson: _emilywilkinson_
Jaidyn: jaidyn_b15
Michael: michaelandersonyzuuvjdpdu
Charles: charleshernandeznbbrwlvzlp
Diert: diert.chith62
Kenneth: kennethandersonqvfxweoxiq
Swalo: swaloviems68
Charles: charlesmooreqyahvhekjd
Baive: baive_anags31
Joymn: joymnslele77
Susan: susanedwardsldplegdagz
Dorothy: dorothyandersonwxawjuhzum
Nancy: nancylopezfqceihznyn
Brian: briancarterjtjxlblrry
Wrara: wrara_opise14
Carol: carolyoungtpkiocnwgo
Christopher: christopherthompsonsczrevkniv
Steven: steventurnerbwwqeyxbvh
Reorm: reorm_sique76
Poini: poini.prame43
Reumn: reumn_glulk44
Sophia Fente-Damers: sophia.fente
Betty: bettymartinezaztqgqiluw
Biand: biandruist84
Serse: serse__anace42
Neoro: neoro_harry3
Brian: briancollinsdpfhkxbbpz
Arina: arina.smeli86
Lisa: lisawilliamsnhyktftjmn
Maria Ross: mari.aross54
Ronald: ronaldperezngkemzlajn
William: williamrobertstyziesroxg
Patricia: patriciahillzrdvpfpkyq
frankie!: frankiee.gigliotti
CAROL: caroluv1174
Sharon: sharonrodriguezkuwsadwtdq
Stulk: stulk.soamp39
Jennifer: jenniferwilsongdzogpngpc
Betty: bettymooreiviweiiwbh
Nancy: nancycampbellebohokyqmn
James: jameswrightzsonxspxjj
Haleigh: ha.leigh409
Joseph: josephgonzaleznxcvsakbqn
Neeva: neeva__keype35
Douth: douthclich45
Poith: poithabsom17
Unsex: unsex_maino38
Alulp: alulp__beauh75
Ruth: ruthmartinezlhqyqstpju
Dinah!!: dinahsaur_t
Groox: groox.roove62
Kitty: kitty__shism29
Mary: marylewisowjkjjxhca
Fumma: fumma__emicy52
Kevin: kevindavisdhrbrorutt
Noime: noime__reusy65
Dorothy: dorothytayloritsoxigren
Donna: donnawilsonwjbhezxpwx
Erolo: eroloweelm78
Excew: excew.feaps74
Faige: faige_erest50
Michelle Poole: rarity_mk
Carol: carolgreencklnbbnjuz
Nancy: nancyclarktmpbewkujd
melynda sylvester: melyndasylvester
Soage: soage_emigo73
Patricia: patriciaallentkwtjwtomr
Oxice: oxice__twign87
Anors: anors__oxita62
Wrant: wrant_traug31
Unish: unish__poups93
Christopher: christopheredwardsgohwsgmoym
Carol: carolturnerommdrtgmid
Mary: marylewisletjgoojaj
Elizabeth: elizabethjohnsonsgxygprgdb
Enlak: enlak__cluts12
Opire: opire_beini23
Patricia: patriciarobertsxllylqrwrj
Mark: markyoungoklamhgdqz
Christopher: christophercollinspdptlkntzc
Kenneth: kennethrobinsonytmudapxvn
Reeme: reemeantab20
Margaret: margaretmartinqgxwvemmyq
Mary: marywhiteffeaibktbg
Edward: edwardbakerrnojmgjdkt
Taify: taify.bioca72
Acurn: acurn.evato17
Votly: votly__diady30
Michael: michaelnelsontfslanwhoc
Snoli: snoliboach67
Fopay: fopay_dieks62
Zesty: zestycunny91
Shine: shine__spoiz32
Susan: susanrobertsewvjikvtzm
Boype: boype__steft91
William: williamtaylorupfjjossaa
William: williammitchelljohlfpbmsx
Opism: opism__geolo51
Noppy: noppy__liade14
George: georgetaylorlivxzvixwz
Edward: edwardrobinsonlkukznbcfy
Frorm: frorm__saste7
Smoom: smoom_bexia54
Taild: taild_adaph75
Mary: marymartinezagovegibbo
Richard: richardhernandezkstxivgvdj
Emand: emand__press77
Prerm: prerm_meant53
caleb :,): cal.eb24
Seedo: seedobougs66
Charles: charlesperezqcrminxxbh
Richard: richardrobinsonvrwiftrizj
Evisa: evisablilt44
Elizabeth: elizabethallenrnvcpysvxs
Drumn: drumnclumn72
Unift: unift.knima25
Richard: richardadamsjphakrqrxz
Mary: maryhernandezmeeflyfhbz
George: georgerobinsonhvykjfxpqc
Nough: nough__imids50
Blasy: blasy_phelm45
Aloca: aloca__sycle87
Theni: theni_shisa90
Michael: michaelperezjfueexpjbv
Elizabeth: elizabethjohnsonwfgzqjwzgs
Paurn: paurn__adume81
Pible: pible.crync68
Dorothy: dorothycampbellwgtmbovygd
Ronald: ronaldhillblypuzhepj
Daymn: daymn_tucky92
Dorothy: dorothyedwardscngmcbetpt
Yaneisi: yaneisiarriaga
khushi: khushi.gandhi
hailey!!: hailey.mp4
sof: sofiefinch
Kevin: kevingonzalezmstsqqapqi
Karla Boussart: karla_boussart1
Leonardo Garcia: leojgarciap
soumil: sou_v22
Annika Hesse: annikathesse
logan :): loganvitagliano
anjolamary: anjolamary1
hamedreza: hamedreza585
Ally: allyyjewelll
Lauren Reyes: danielcahnspeyer3
Vaishu: vaishumarreddy
Elizabeth: elizabethxgerber
Rosalinda Perez: rosalindaperez4002
jordan lovoi: jordanlovoi
camille gm: camille_agm
ELISE MORAN: eliseemoran
Andrea Aragon: andreaa.arag0n
Shivani Jariwala: shivani.jariwala_
Tommy Pope: tommy_pope5
Allison L.: all.is.on56
YUNI: yunijewelry
lexie miller: lexiegmill
kayla: kayla.sorge
kiera: kiera.kubiak
Alejandro Lopez: _alejandrolopez4
myles: myles_awayyy1
Melanie Charron: mel_charron4
Charlotte Eades: char.eades
Kelly Do: _kellydo
varsha :): varsha.ven
Maryam: maryamelbeltagy
Brighton Mooney: brightonmooney1211
Carlos Hinojosa: _carlos_hin0
Emma Elizabeth: eliiizzzabeth33
carly gaudin: carlygaudin
Sergio: sergio.t__
aarushi: aarushichitagi
Deba Osague: deba_osague
arielle: a.ria.lle
ENA: ena.k
freddy: freddyguo_
Sebastian: sebastian_bourbon33
zoe lemaire-jones: zoej217
Cesar Picazo: cesar.picazo88
jacob hernandez!: jacobh.04
Mary: maryccreel
Lauren Dulac: dulac_lauren
chenyi: chen.yi.wang
Hannah Koepp: h_l_koepp
holland: holland.mundorff
Wyatt Rubey: wyatt_kr
Waamene Yowika: imsognarly
Christoph: christophxklein
taco :p: bela.davilaa
Hector Mendez: that.one.guy.hecto
avery schilling: aveschilling
Donna Waitkus: donnawaitkus
Jared Orkin: jared.orkin
Maddie Amezcua: maddieamezcua
Sree: sreeduggirala
maekayla effinger: maekaylaeffinger
anjali :): anjalicherukuri
dylan hauglid: dylanhauglid
: yousefkamall
paige simpson: paigehayley.s
Tori: victoria.rodd
Austin Gardner: austinthescholar
Pranav Akkaraju: pranavakkaraju
Cate Casey: catecasey_
Alicia: alice_ia.rose
ainsley:)): ase_722
Kimberlyrobin97: kimberlyrobin9797
Samantha L.: sam_leidel
gauri: gmishr4
Sydney Hunt: sydney.j.hunt
Lizzie Coyle: lzcoyle
Katelyn Puello: katelyn.mia
crystal zimmermann: crystalzimmermann_
Maddie Wueste: maddiewueste
Sam Lu: presidentsamlu
Ali Zaidi: alizaidi_04
Mia Rosenberg: miaarosenberg
michelle: michelleeerivas
jerry: jerleecab
Madelyn Leonard: madelyn_leonard
: duhitsavezzz
becca :): beccabeinart
gabby: gabbybesnard
tamara: tamarajrhodes
Ellie Hague: eahague99
Jamie Ordonez: haiiimeeee
Chloe Bennett: chloe_maybennett
Natalie Fetter: nataliefetter27
Nathan Pannell: nathan.pannell
Alysa Madriz: alysamadriz
jaida.beede: jaida_beede
Lindsey: lindsey.regan2018
Mason Ott: ottmase
regan walker: reganwalkerr
support the orphans: mwesigyajohn2
Betty Weaver: bettyweavertn
: aydan.castanon
Jack Borgeson: jack.borgeson8
Adnan Allan: adnan.alh74
Dhdjsksggsiagsj: sgskshsgsms
Jenny Cope Warden: jennyw6
Nihal Mohammed: nihalmhmdd
Sarah Catherine: sarahcatherinecrow
Liam: liamstemetzki13
kenady: kenady_cooley
Allie: alexandragajak
Texasforever2024: texasforever2024
Dani Rose: danimirin11
Hannah Wehofer: h.wehofer
Jenny Chung Lew: jennychunglew
S O P H I E P A S C A L: sophiexpascal
Brian Pena for COLA Rep: brian_for_ut
Madi Miller: madelinemiiller
Olivia LD: olivia.j.ld
Jillian: jilliantaler
Patrice: patricehayes_
helaina gilmer: helaina_gilmer
SALLY CASTER: salcastrrr
Sofia Frey: sofiafreytx
CLAIRE SIRCELY: claire.sircely
Olivia Gerhart: livibeannn
Lauren Jeanes: lajeanes04
hope: hopecoltrin
: arpan.shresthadg
anvith: anvith_reddy666
Sohaib Khan: sohcool23
Alexis Hunt: alexis_hunt_
Heath Harris: heath.harrisss
Morgan Marie Hernandez: morgan_m_hernandez
Gini Dyer: ginigdyer
Amie Nguyen: amiednguyen
Amir Kian: amirkian_.info
Jordan McAlister: j.mac41
kenzie: mackenzielautnerr
kelly liu: kellyylliu
: megan.dedmon
emily: emilyygottshall
sophia labeau: sophia.labeau
samantha: samanthawlodawsky
rebecca: rebecca_oladejo
Maddie Hymowitz: maddiehymo
Vanessa Nguyen: vanessaanguyen
Ty: ty_wilson29
shaili shouche: shailishouche
Yasmin Jenna Jackson: yasmin_jenna_jackson
Nerwen Cao: caoyuqing130
Lauren Darzy: laurendarzy
kennedy renae: kennedyrenae_
madisen lieberman :): madisenkate04
Kelly Riley Callaway: kayceecall
Perise Sasa Siaosi: p.erise
gracie leal: gracie.leal
Noah gee: ngee2025
diya bhatia: diyabhatia27
jenna struck: jenna.struck
Genna Adelizzi: genna.adelizzi
Katherine: katherinefrazier_
Ryan Karkowsky: ryankarkowsky
Ben Wells: benwells15
alexa: alexanuncio
Ryan Couron: trexcouron
mahek dodani: mahekk.d
isabel redwine: isabel.redwine
Alex VonHaven: 8_alex_v_8
Aditya Sangana (Airbender): adi.s.7
anil cacodcar: anilsc5
KP: kayla_prevost
Isabela Salazar: salazar.isabela03
J-Sprad: jaque.spradley
Meg: meghanclearyy
Dana Bundy: dana_bundy
Isabella: isabella.y.wade
Nehir Aran: nehir_aran
hannah mccormack: hannah.c.mccormack
lu bierrenbach: luisabierrenbach
Julissa: julissarojass
: kynadi.jones
Elyse Rosario: elyse_shelli
hailey smith: hhaileyysmith
: _._jinna_._
Sophia Lagen: sophia.amaliaa
David Park: davidpark_03
ania davila: aniadavila
EMMA GRACE ALVEY: emmalvey
luna: lunareichert_
kendall karoline :): __kdoll__
•Meredith Rillera•: meredith.rillera
becca!!: beccabalan
Ali Bhai: alibhai002599
Isabella: isabella.sruiz
Olivia McMillian: oliviamcmillian
Nikolas Parker: parker.nikolas
Tiana: tianawang05
Colin Angel: colinjangel
raely fitch :): raely.f
Lalit Metta: lalit_metta
Nithish Oommen: nithish.o7
Mark: markl0cas
miriam zewdu: miriamzewdu
bella: bellsdom
Gabe: gcweaver03
Ayush Sheth: 1006ayush
Aldo Frausto: aldo703_
Amitabh Kunchey: festus11725884
gaby zurita: gaby.zuritaa
Kristi Griffith Quick: kristiquick_
Rimsha: riimshas
Billy: disastrous_paracetamol
Justin C.: jstn_n_cln
: genevievehendrie
hannah: _hannahcleveland
hailey: haileyywilliams_
Omolivie Eboreime: liv_eboreime
abi: abigail.jolie
Byrdi Beggs: byrdi_maye
Siena Theivagt: sienatheivagt
Sophia Steinauer: sophia.steinauer
Sana Kohli: sanakohli1
Rikke Burke Graber: rikkegraber
Lucienne: lucienne.moran
Liv: oliviavarcalle
Ben Ridder: ben.ridder_
Martin Mulinix: martin_mulinix
Olivia Rocha: oliviarrocha
Sorority Prep: sororityprep101
taylor: taylorrmoran
Vivek Patel: vivekpat.el
K I Y O N N A: kiyonnakapoor
Mia-Katherine: whatsamia
tay: taylor_channn
Sophia Brod: sophia_brod
: sahanakaushik
loulou: loulou.worthe
Steph: stephany_mmiii
Andrew Zheng: andrew.zheng_
Will Pechersky: willpechersky
marly shawky: marly.shawky
Denise Bava Howe: teamhowe5
hailey hirsch: haileyhirschh
Caleb Geyer: caleb_wisemangeyer
: phoebe.cosgrove
Molly Garvin: mollygarv
H A D L E Y: hadleycgardner
audrey: aud.sperry
Lily Barrow: lily.barrow
College Merch: marmos.art
emma fults: emma_fults
Lily Davis :): lily.davis24
loran johansen: loranjohan13
isabella martinez: isabella.martinez22
Sara Hickman Ridder: sararidder
Megan Lam: megandlam
Adelle Hinson: adellehinson
issie: issiemagee
shruthidandamudi: shruthidandamudi
amber liu: ambersongliu
Joey: joemerickel
Ricky Rodriguez: rick.mo.03
Ryaan: ryaan.hussain
cam anderson: camrynanderson_
Ava Wiederaenders: avawiedey
: _ishaaa_d_
Leviticus Gay (pause): luckyleviticus
Jordan Norris: jordannorriss
Isabel Aldrete: iisabelaldrete
Bella R: isabellaflorencee
Sushan Chaudhary: sushan_chaudhary1
maya orenstein: mayaorenstein
Natalia: nataliaia.m
Varun Vedala: varun_vedala
sydney!!: sydneyyfulton
rabah: rabahanwar
Siddhi Bansal: siddhi.bansal
Nidhi Pabbathi: nid._.hi
Emilia: emiliatornoe
mady kahn: madykahn
Anna:): adobre25
Ario Torkashvand: aryo_torkashvand
Annee Athar: anneeathar
: taylorrhoadess
shivani: shiivaniikumar
Allie Alton: allie_altonathlete
Payton Thurman: payton__thurman
Morgan Davies: morgann.davies
ELENA SOFIA: elena.c_
nicholas: nicholascristan
Sarri: sarrionna
Briana John: brianajohnn
Jungmin Kang: itsjungmin
Gracilyn Hardy: gracilynhardy
Kashish: kashishh.sawant
Reeba Abraham: reebabraham
krissa:): krissajhaveri_
: rahulabraham03
alex levinson: _alex.levinson
brendan: brendanreynoldss
Rylee Roe: ryleeeee_r14
DANIELLE PETERS: petersdaniellee
Aidan Leonard: a1danleonard
Julia Genin: julia.genin
Anna Kate: annakatekelly
~ Arianna ~: ariannaaa.jimenez
Emma Milton: emma_l_m_
Jenna: jennaabulughod
Will Townsend: will.townsend03
sydney lamphier: sydlamphier
Brianna Clinkenbeard: cli_nkenbeardbrianna
emily long: emilymiriamlong
Sarah Shelton: sbshelton04
Gia_marie.: gia_marie_1
Jaqueline Del Angel: jackie.da
regina pina <3: regpina21
Leah Weisglass: leahweisglass
schottman: elly.schottman
Emma Nagle: _emmanagle
Kate Carvalho: katycar_777
Annika: annika.gabrielle
Monica Hecker: monicahecker3
Kezian Dunn: keziandunn
Ryan Sobol: ryan_sobol
sabrina merkle: sabrina.merkle
anna phillips :): annamichelleee
: yaasmmeeen
Tapasya: tapasya1807
Keira Rusinko: keirarusinko
Will Peters: willpeters03
Siddarth Rudraraju: siddarth1703
Emma: emma.nicole.m
Paige: paigemeridian
ryleigh:): ryleigh.m0
Reese: reese_winn
Jafrina Rahman: jafrinaa
Pope Rivera: privera_24
Adriel Bustillos: adrielb.08
dev: dev.21_04
Samuel Dunkerley: samdunk1234
alex<3: a.alex_pacheco
lili!: lili.toledoo
ARIEL DOSS: arielmargaux
madelyn grace: madelyn_troy_
Andrew Tang: an_drewtang04
karissa: karissa.susie
Ryland Marshall: rylandm23
Tommy Bannon: thelifeoftommy_21
Sid Baskaran: sidnb13
Meghana: me.gh.ana
dani: daniellalf06
Corinne Piorkowski: ccorinnep
Naga Yatham: yathams
Tommy Brigham: tommy.54321
Reagan Schluter: reagan.schluter
Michael Sendejo: its.raining.tuna
Mike: michael_khalfin
daniel: __dani.t__
laura haas: laurahaas12
kind of kind: kindofkind.tx
Sanaa: sanaaalewisss
: edgarcohort
Yuri Lee: yuriii_lee
Samyathi Katta: samyathi.katta
Mikey Laderer: mikey.laderer
Jordan Cruz: jcruz4512
nick n: n.ng04
Jordyn: jordynfeenberg
Ellen Sterin: pursefrenzy
sophie sorkin: sophsoph04
Owen Johnson: owenjohnson28
Emma Centanni: emma_centanni
Shelley: shelleysorkin
kyra: kyra.schobel
fiona: fionacosgrove_
Hannah: hannahhstevenss_
mia: miafupetersen
Alexander Dunaway: alexander.dunaway
had: hadley.olsen
luke: luke.blausen
Cathy Tovtin: ctov
lia bloom: lia.bloom_
Tori: tori__deawesome
Jack Newman: cactus.jack03
Elizabeth Garcia: elizabethlandrygarcia
Annabel Lane: annabelslane
Logan Wright: logan_lt40
emery whitford: emerywhitford
julia<3: juliaraghu
Naomi Murphy: naomi_murphy22
Ethan Fang: efang_12
: artistic_girl5
: bryanscalixto
Jack Staton: jack_stat0n03
Ashleigh Prather: johnny._.cashleigh
ava holt: avareneeholt
Francisco De Souza: franciscodesouza_
Anika Mittal: mittal_anika
Farzan Shiju: blufiusmarqueetii
Maddie Mandel: maddieemandel
andrea valen(tina): _andreamontenegro
: suma.ya1581
James Mayen: big_texmex
nataly: nataly.oliv13
marlen: marlenjuarezz
jayde hamilton: jaydehamilton1
Walker Francis: walker_francis
Neil Goyal: neilgo12
eesha: eesha_nayak
jeremiah solfronk: jeremiah_solfronk
Lorenzo Lavigne: lorenzo_lavigne17
lily: lilyemartin
Sophia Nguyen: lifeofsophianguyen
sophie cain: sophieecain
Dhruv: dhruvp04
Isa: isa.kazen
Calvin Mauldin: calvinmauldin_
madi silver: madison.silver
Lane Johnson-Martinez: ginganinja2166
Hudson Parker: hpark.1234
Lily Anna Nichols: lily_anna_n
Julia Campbell: juliacampbellatx13
Bailey Evertson: bailey_reese22
Sarabeth Hawk: hawksarabeth
Galit Beraja: galit.beraja
savannah lavelle: savannah_lavelle
Expert Writer: essayexpert68
Debbie Nelson: debknelson
jas: jasmineeweng
Robbie: robbie.valcarcel
giovanna: giobustilloss
sophia campbell: sophia.renn
sarai <3: sarai.915
Harrison Alexander Funk: funk.xander
danielle: danil_01707
kate murphy: kate.murph_
Will Reed: wreed17
Julia Cherkesov: julia.ch164
: kassandra.jimenezz
Carly Freeman: carlyfreeman5
ave;): averyy.raynee
julia quigley: juliaquigleyy
Elizabeth Scott: elizabeth.sscott
bk: bbrookepatterson
giovanna <3: giovannamcleann
Isabela Salazar: isabelasalazar061003
Surgeon: edwardrios._
Miloni: miilonipatel
Carson Domey: cjdomey
Taylor Eckel: taylor_eckel
Joey Spiro: joey.spiro
isabella: isabella.rosess
Amanda: amandathegallo
LEXI: alexisdmalone
Jasmine: jrmer_25
Jana Madi: janaamadi
Four Bybee: 4bybee4
Liv: livschlossman
sanya <3: ssanya.g
felix !: ffelixjegede
Mary Katherine: mkpalmer_
Halimot B: halimot_b
camryn: camryn.courtney22
mairany: mairrany
Gia: gia.rose._
Quinton Mendoza: quinton_mendoza
Charlotte: charlottegbrown_
Lauren Rosen Levinson: lrlevinson
rhea :): rheanna.patel
Jennifer Myers-Wong: jmyerswong
Dylan Michaels: dylmichaelss
Jessica Callas McAnelly: kravingkarmajessmcanelly
adi: adison.viars
I S A B E L L A: isabellababba
Shalini Parepally: shaliniparepally9
sarah winnier!!: sarah_winnier
harrison: harrisonhensleyy
McKenna Bayless: mckenna.bayless
Elizabeth Hannam Hamilton: elizabethchamilton
Ellington Hull: ellingtonhull_
Senior Shoutouts: seniors.shoutouts
Pari Latawa: parilatawa
Austin: austin_friedman13
Evelyn Sheahan: imevsheahan
Orlando Rodriguez: orlando_6634
mason: mdblalock
¡katie!: katiemfield
Riley Schultz: therileyschultz
Steven Nguyen: stevenqtnguyen
margarita ovalle: maggieovallee
ciara <3: offbrandecici
Lilly: lillyredwine
Rohan Rumalla: rohanrumalla
cam: vcxmden
Mary Nelle: marynelle_cravens
SGT Rodriguez Christian: sgt_rodz_healthcarerecruiter
laura: laura.merlina
Chloe Miller: cchloemillerr
ava thomas: avaa.thomas
Alyssa Klein: alyssakleiin
Lillie: lillian.kate
modeling: mina969090
claire: claireschulter
Omar Almeida: omar_almeida11
vashed<3: vashedthompson
hope vanderburg: hope.vanderburg
zafra <3: zafra_haque
Texas Swifties: texas.sas
anna: _agrove101_
Lily t: _lily_t_0416
karí :): _karina_ila
Everett Sawyer: everettsawyer
Ruby Manley: rubymanleyy
keelin <3: keelin.finley
becca:): beccarincon
: drewcohen11
Rohan (Rappin Ro): rappin_ro
Jamie Brooke: jamieweinbergg
annika lærum: annikalaerum
maria de vasconcelos: mariadevas
William Mauldin: mauldinwp
Aleksandr: md.jannat231
BELLA FRIEDMAN: bellafr1edman
Lauren Spurr: she_looks_so_spurrfect
Jack: jackbdixon
Gray: graysencarlsen
Rahul Chalamala: rchalamala
Texas Universities 2026: texasadmits2026
: carlyymccausland
: jacksabo_
Lucy: luciana_smc_
Ria Gujjar: ria_gujjar_
Sophia Pehr: sophiapehr
Naveed Sadarulanam: navs4601
Adeline Trojacek: addie.graceeee
alyssa lugo: alyssa._lugo
Salma: sallisal15
: k.bhakta04
Cristian: ritardando.xd
Danielle Alvarez: danielle.alvv
l i l l i e l o o s e: lillie.ann_
richboyflame9: richboyflame9
Yadira: yadira.vega.0024
Madison: _madisonconn
Evan Chambers: echambers_
hannah smith: hannahsmith_324
vice: blackrabbit.xx
emily: _emilyboler_
John Mentgen: jam0010
Christos “Taki”: tpsaropoulos
Izcan: izcan.ordaz
riley kate: rileypracht
iliana dentchev: ilianaamariaa
angie blair thorpe: ang_thorpe
k i m i: kimizonouzy
Katlyn Huynh: katlynhuynhh
sophia shelton: sophiavshelton
Myles Johnson: myles.johnson04
isabella: isabella.ravden
Khun Cho Thar Lwin: khunchotharlwin
Mala Gupta: malagraceg
Noah Pineda: noahpinata
Vince Smith: vincesmith_
Evan Craig: craigohaslosthiseggos
: nickwalsh7
Shaan: _shaan.n_
Isha Mukherjee: isha__mukherjee
lex!: lexjoness_
G: giuseppa.sanfilippo
kelly graham: kellyy.graham
Haydeeth: haydeeth__
TJ: itstjkohli
Rokon: rokon6006
uly: ulyhateseveryone
Zach Snyder: zachsny26
Samuel Brack: samuelbrack_
Fritz Thomas Stucki: xenofyen
Debbie Ballard: debbie.ballard
ELIJAH WILLIAMS: llijah__
morgan bangert: morgan.bangert
taylor lin: t.tayyylor
makenzie: makenzie.long17
LittlePancakes: thelittlepancakes
Kylie Jo: _.kylie_jo._
Phia Parent: phiaparent
monii: monica.monii_
Allie Singer: allieesinger
rushil: rushling18
Rosie Carlton Glassford: rosieglassford
Ava Acton: ava_acton
Natalie Lawless: natalie.lawless
Shayna Meek: _shaynameek_
_Shahobiddin: _shahobiddin_942411200
Leslie Saenz: lesliee.ees
: danifriedman_
grace!!!: grace.stern
anna montgomery: montgomery.anna
Anna Beasley: annabeasleyy
Tate Elfarr: tateelfarr
mel: melat_w
Abhived Pulapaka: abhip636
Casey Buchanan: casey_polarbear
Emily Nguyen: emilynguyen522
Paulina: pauuvictoriaa
shree: shreeganeshh
shelby campbell: shelbyhcampbell
amadee garza: amadeegarza
carolyn hendrix: carolyn_.anne
Imelda Delgado Trevino: amom_22_boys
A b b y F a i n: abbyfaingarrett
Gabby Norman: gabby.a.norman
Emma: emmaemigh
Nathan Su: classicnate_official
Sydney: sydthesciencekid807
Will Anderson: andersonn.williamm
sage rose: sagefuhrman
tatom: tatom.hoffmann
catia rodriguez: catia_rodz
: reeseertel
rishitha: rishitha_v
Sourik Sannigrahi: sour.ik
: liam.earthman
Ainsley: ainsley_nelli
Nate Heffron: n8heffron
Alexis Morales: ahh.lex.is
kate white: kategwhite_
Lauren Murphey: lauren_murphey
: caseymarvin_
biya :): biyacham
thomas chun :): thomaschun_
Netra: netra_krishnan
anne: anne__porter
Sophia Vlahakis: sophia_vlahakiss
jacob umbarger: jcumbarger
SARA ABDOLI: saraabdoli62
Adam: adam__ily
Jacob Lee: jaccob_._
Ava Picone: avapicone
Abby: abigailrodionov
hannah nixon: hhannahnixonn
Kenneth Garcia: kennethggarcia
Sanjana: sanjana.sen_04
Dominique Maldonado: dom_._._marie
MATTI: mattilaeskye
Mahdia Rahman: mahdiaaa._
Sneha Joseph: sneehaj
Inaya Momin: inayamomin_
Zeba Sajid: zeba_sajid
raunak: raunakmanchanda
emma cate: emmacategall
: l3naaaaaaa
MACY: _macy.smithh
kendall :): kendall.quick
Amber Castro: amber.castrooo
Ernesto Vargas: ernestovargas1803
khalil :)): _khalilmalik
alexis: alexismorrisey_
o d: livvdavvv
ella grace: ellagracewhite_
Katherine :)): katherine_nix
Nancy Bathurst: nancybathurst
Melani Thapa-Magar: melaannni
Julyssa Cantu: julyssa_cantu
naina dhawan: naina.dhawann
Leila Rabah: leila.rabah
N O A: noamoore
Jackson DeBorde: jackson.deborde
Isabella Forestieri: isabellaforestieri
Camila Marden: camiiiii.i
krithika karthikeyan: krithika.karthikeyan
Jeanne de Moucheron: jeannedm_09
Alexis Hansen: alexisahansen
G I A: giaperel
Leslie Gonzales: lesliie_g13
Briana:): briana._.zuniga
: jay.815
michaela:): michaela.huffman
Riley: rileytendler
marin: marincroix
Brennan Emeka: brxennan.x
chris lopez: nuychris
Roma Subhir Patel: izromapatel
•jessica jewel tidwell•: jessie.jewel
Anna Cristina: cristina.canepa
Avery Croft: avery.croft
Jessica Mikell: jessica.mikell
Natalie Berry: nbberry313
Anay Patel: anay111803
Kevin: kevinscontreras
peyton:): peytonhilfinger
lauren rivas: laurennrivass
zamira elizabeth: zamiraaae
Sam Habashy: habashy.sam
Bryce Strongin: brycestrongin
Caitlyn :): caitlyn.snedaker
ricky: ricardoo.ortiz
: avabarrera
kate: katemoravec
Maddie Savasky: maddiesavasky
Kohlton Mathis: kohltondmathis
Laura Christoff: laura.christoff
Leah Plowman: leahkplowman
Grant Brewer: gm.brewer
: 0liviaperrin
mayan brittin: mayan.watson
leah: leahc.barragan
Sejal Goyal: sejalrgoyal
Daniel: dat_danniboi
jonathan shoe: jonathan.xu
sophie kolbe: sophiekolbee
Yolanda Ramirez: _yolie_mae_
betsy goodrum :): betsygoodrum
: andrea_gh4
Aliyah Banerjee: aliyah_banerjee
Shannon Mcbride-Strole: sstrole00
emma hunt: e.mm.a.hunt
A-Y!!: _ahyoungkim
Hasan: hxsanmurat
Shrey Kapoor: 777shrey
Gavin Calhoun: gavincalhoun
Jacob Sedlacek: sedlacek.jacob
ashley pfeiffer: ashley_pfeiffer23
Filza Momin: filzamomin
Maxwell Diamond: maxwell_diamond21
Willow Kerr: willow.kerr
avery: averyengleman
Samantha Dworaczyk: samantha_dworaczyk_
Aryan Samal: aryannn.samal
Kamid Lozano: kamidlozano
abby kremer: abby.kremer
Yêãhïã Kháñ: yeahiakhan_555
daniela osorio: _danielamosorio
Katie Poulter: katieepoulter
Leo Serfaty: leoserfaty
Lauren: lauren.lambrecht
Camryn: camryn_222
Roro Imarah: roro_imarah
Les: leslyyy_cruzz
Lauren Nguyen: laurenguyen1
Marely Hernandez: marelyh3
AVES: averylins
lily: lilycoannn
maja: veracmaj
mimi <3: milicakonatar
Steven Brod: sobej
GRACIE: _graciekent
Clark Edson: clark.edson9
Abby Grosshandler: abbygrosshandler
Lisa Aldana: lmaldana20
Lexi: lexigrace.22
dani: danielaipatino
<3 T: taylor.k.anderson
Raymond Cullen: raymond_cullen9
Caley Aycock: _caley_13
Juliana Sarria: juliana.sarria
Nicole Seiler: bedazzledbottlesnicole
ali1234aaa: ali1234aaa8
Hailey Lockett•: hailey.lockett
Heather Doornbos Boler: doornbosboler
Layne Herington: layne_herington
Aneesh: aneesh.harwalkar
Sean Avery: sean.averyyy
: gucci._abraham
Claire Yaney: ccyaney
: jacqueline533
Lauren Weider: laurenweider
Upper Media Rentals: umrentals1
Dylan Recker: dylan.recker
savannah matthews <3: vannah.n.m
lila: lila_orr
TyErica Gill: tyericagill
D'Ann Colley: colleypartyof4
isa: isa_garzaa
: ella_porter31
Daniel Tzalik: danieltzalik_
Ross Wilkins: rosswilkins1
kate: kateaaguayo
teresa nieto: _teresanieto
ava richards: avaann.r
Shawn Berger Hickman: shawnybhick
mya: itsmyalacey
Maci Lynnell Lowery: macilowery
lex: alexa_varela
manny: manny.delacerda
Cyrus Bronson: cyrus_bronson
Ian Furrh: ianfurrh
Mia: mia.latigo
sadeel: sadeelhammad_
Nate: natebroidy
Dalya Sachs: dalya_sachs
Audrey Wilson: audreyrwilson
Haylee Bush: haylee_bush_
: swlkrrr
nataly: natalyoviatt
Dhillon C: dhillonc9
Michael Hardie: mhardie12
Rea ;): reaganwhitehouse
hello shawty: walker__blake
Raleigh Ward: raleigh.fw
Adam: ad.am5141
Samantha Wiedemann: sam.wiedemann
paco cheung: cptpaco831
Taylor Gardner: taylorgardnr
Joshua Allen: josh24allen
juliana jaasma: julianajaasma
lucy.: lucyybergerr
rhea: rheaa.sood
Georgia Ann: georgia.everetttt
julia schwaeber: juliaschwaeber
Destin Drummond: dezdrummond
Laura: _laura_baker_
: amandaharrelsonn
Aly Lucio: alyanaluc
Isabel: isabel_dahl
CUTE CUSTOM COLLEGE CLOTHES: annikascustoms
Natalia Cordoba: naticordobab
Britton Merritt: britton.merritt
Gabby Aguilar: gabby.aguilarrr
nat: natalielongacre
landry: landry.kern
Sammy Martinez:): _samara_martinez
Stacey Hull: staceymhull
Nate Typrin: nate_typrin
Sofia Di Salvo: sofia_di.salvo
Kasey: kasmur
A L E: ale.merodio
bren <3: brenleefox
Michael Berman: michael_berman16
Stephanie: stephanieee.brown
Jordan Yagaloff: jordanyagaloff
caroline: carolinecockrell_
: marvizzworld
Carlos: _karlos03_
kooper kohut: kooperkohut
Ramsey Perez: itsramseyperez
Alexis Vasquez: ale.vas13
Batul Hasan: batulhasan
Linz: lindsey.hughes
myranda duran <3: luv.randa
chris a-mayonaise: some_stranger_2004
Hayley Wetzel: hayleywetzel
lindsey bennett: llindseybennett
Samantha Lee: samfaithlee
Alejandro Garcia, REALTOR®: acho.g
Arslan Ahmed: arsal.ahmed.77
Kristin Pitman: kristinlashelle
Luke Reed: luke_reed_44
Elizabeth Conneely: elizabeth.conneely
Angel: angel.nolasco04
masyn!!: masynwernecke
crimsonxgold: crimsonxgold
Emma Lawrence: emmalawrrence
Sophia: sophia.3100
Austin bartlett: abartlett24
emi: vdzemi
Lili Tomko: lilitomko
Mæ: mae.rizk
jules :): julesmurillo4
A L E X: alexcussimanio
Kennedy Bicksler: kennedy_bicksler
Lourdes Cabrera: louccabrera
Jason_sharer: jason_sharer
maddox: maddoxmyane
Mia Wurster: miawurster
: pardapear
anna: annasophiamarttinez
Dre: dre.rothb
Andrew Rovit: arovit2
lizzie: lizziekbrown
trin: trinity.ivy
lauren :): lauren_.simpson
jackson sacher: jackson_sacher
Logan Rosas: rosas_logan
bella martinez: bellasophiamtz
christine gerhard: christine_gerhard
Zander: remy_uwu
Libby: libbymtempleton
NEVAEH: nnevaeh.b
vivian montoya: vivianmmontoya
Mihir Asnani: mihir.asnani04
Nayeli: _nayeligonzalezz
mauldinlc: mauldinlc
Shiva Balathandayuthapani: shivab_29
Carolynn Brower: carolynnbrower
Kim Schwartz: kim_c_schwartz_
pri: bittersweet_pri
fernanda herreria: fernandaherreriaa
lily gribble: lily__gribble
: sophieeharmon
Sam Battle: sam.battle.11
Jacky Casey: jackycasey
mikey gavranovich: mikeygavr
Abby Daehler: abbydaehler
Eric Gomez: ericgomezzz4
Rosy Franco: rosy1.franco
emma: emmaaamoncur
Sophia Sandoval: sophiasandovall
kirsten: kirs.ten909
Brooke Rogers: brookerogers08
Zeke: zeke_33_
: howyouknowpenn
Cole Dermanoski: dcdski
Kanak Kapoor: kapoorkanak
Jayme Thompson: jaymemthompson
Dariel Naval: itsdarie.l
abby: abby_hecker
Emily Schottman: emschottzy
Kayla Ngo: kaylaxngo
katie roque: _katieroque_
: luke__moyer
Analuisa Castellanos: analuisaaa.c
christianna m.: chr.xssy
Anish Doshi: anishdoshi04
m a r i s a: marisakapavik
kennedy mayer: kennedy.mayer
shan: shannonmcgovernn
gracie: _gkirsch
Addie Lilley: addie.lilley
ashley: ashleynjohnsonn
tanisha padhi: tanisha_padhi
GABRIELA: gaby.marquez_
Kiersten: kierstenfinleyy
Avoiz: avoiz_whamb13
Lucas Bianco: lucas.bianchi_
averie varnado: averievarnado
laura: laurasalazarrrr
Netra: netra.bhargava
egya reddy: e_reddy19
MARISOL PALMA: marisolpalmaaa
KosMoEthnicFashion: girishku007
brooke barron: brookeebarron
mercy.arely.solis: me.ar.so
Brianna Mata: briannaamata_
Law: lawson.mcleod
caro: _caroliiina_
Abigail Quintero: abigaillquintero
Lauren McKay: lauren.mky
AVERY SCHWARTZ: averyschwartzzz
olivia gonzalez: olivia8gonzalez
milla gideon: milla.gideon
laura j: llaujimenezz
sanjana: sanjanadandu17
Ethan Rubenstein: ethan.rubenstein
lilah bowers: lilahbowers
Carles Noé Guerrero: carlesnoe_guerrero1
Lauren Silver: lauren.silver
Esteven Christopher Polio: esteven_polioo
Kate Sircely: kate_sircely
Santiago Ortiz: santihortiz
: anthonyjsanchez
Dylan Haefner: dh3f_
Lo: loganwinshipp
glenda noemi: glendadiaz381
Andrew .J (El Presidente): real_andrewjackson09
liv mcbath: livmcbath
Dickson Addo: dickie.addo
Walker Thornton: walkerthornton_
Ryan Spier: ryan_spier
Galiguer: galiguer_manjarrez
skylar stepp: skylarstepp
Raiyan Amin: stunnasaad
Hudson Yezak: hudson_yezak
: mayaglennn
dain: da1n_03
Zona Johnson: zona.johnson
Henry: henrybturner
Shayna Setoudeh-Maram: shaynasetoudeh
Julian C.: juliancastillo__
kyle nolan: kyle_n1
caplan5: caplan5
caroline baird: carolinebairdd
Chantz Bell: takeachantz_
Kenny Cruz: kenny._.cruzz
Talon: talonblottin
Suzeth Roman: suzeth_roman
harsha: harshakosuri_
Elijah Hernandez: theelijahhernandez
isabella !: isabellaa.34
ava werner: avawernerr
Marcella Hilmi: co__cella
A•D•D•I•E: addison.kate75
: bridgefinnerty
LAUREN: laurengchou
Caden Dragoo: cgd99
Sydney Malawer: sydneymalawer
Kaeden: kaeden_th
Susanna Brass: susanna.brass
Tor_recipe: tor_recipe
Grant Marshall: grantmarshall79
kate sterin: katesterin
bg: brooklyn.garza_
trevor hopkins: trevperro
danny dougherty: dannydougherty_
Charlize H. Supapo: csdollahz
tyler: tylerkpeterson
: farah_ashmore
Carson Kennedy: carsonkennedy7
Beth Jaeger: bethjaegerr
paige: paige.strole
Saleen Nyman: saleenbelle
Lucie<3: lucieruizz
Cate: cateadamss
: llaurenpattillo
Avery Davis: _averydavis_
Charlie: charlie_barker___
Michael Okooti: michael_okooti
Grace Capell: grace.capell
Serenity V: versai777
Riley Smith: rileyy.s
alyna: alyna_j03
parmida: parmidakhajeh
Cole Merritt: cole_merritt
tanu tripathi: _tanutripathi_
Allie Gardiner: alliegardiner_
Melissa Frensley: mfrensley
Claudette Lopez: claudette_lopezz
Stephen: stephen123009
brooke <3: brookedauderman
Joe Callahan: j0ecallahan
Caleb Solorzano: caleb_solorzano
jasmine: jasminehamway_
Josh McKenna: joshua_mckenna868
Connor: csh_16
MCKENNA: mckenna.waggoner
A-train: big_baller111213
m.: marianaabenavides
Xymena E <3: xymena_escobedo
Allison Pearson: allypearson22
Kapil Nathan: feel_the_nath
Cameron Parham: cameron.parham
Ginny Erickson Ebben: ginny.ebben
Shawn R. Campbell II: romell_vibes
james kair: jamesakair
Lauren Schiele: la.uren_schiele
catherine: catherinecutbirth
NOA MILLER: noamillerr
piper: _piper.elizabeth
Patricia: patriciaegarza
: jackdmcmahan
Alec Enyeart: _swimmer_alec_
priya n herman: priyaherman
Anna Nowlin: annakellynow
Snowflakes: snowflakes_onthelose
: matt.defilippis
Lily: lilycaplan
Edu Halfen: eduhalfen_
Lori Williams: llwilliams1
Austin Woolard: austin.nichole36
Lauren Price: laurenprice74
: sabujrayhan2019
Pehlman “Anything Is Possible”: carsoooon_peeeehlman
Evan Leeper: evan.leeper
Lauren Dunlap: lauren_islegit
: taylor.felton
Christy Satterfield Robinson: christyrobinson0227
Peyton: peytonccasey
extendedcampus.utaustin: extendedcampus.utaustin
Storage Scholars: storagescholarsut
Safar: sa.far4639
Megan Trieu: megan.trieu
mireya !!: mireyamedel
L A I L A: lailanguyenn
rachel connolly: rrachelconnolly
David David: davidwdavid
Sydnie Karel: syd_karel
chloe: chloefeyerick
Carter Hull: carterwhull
Alison McDougall: aliemcdougall
Alexis Headrick: aplexx990
Theodore Daskalakis: tydask
kate: kat3br0wn
Autumn Beck Blackledge: autumnblackledge
David: davidramerig
: alliecruzz
jada kabani: jadakabani
Andy: andres_garciajr
Colin Felan: colin_felan
Susan Beaubouef Quinn: susanquinntx
Charles Sellström Berry: charles.brry
aiden: aiden.tijerina
caroline cullen: cvroline
Nikhil Shah: indian_head_nikhil
erin chaires: erin_chairesj
Carter Moxley: moxley_2020
John Marian: johnmarian_
ainsley burns: a1nsleyburns
Mick Racenstein: mickeyflies
Dabir Syd: dabir_syd
mads: madison.demauro
wyatt: wyattmcglaun
Nia Taylor: taylorcolin0
whitney gilley: whitneygilley
T. Wessley: alphasource2
Evan Woodward: evan.woodward
Emily Hebert: emilykhebert
micah barker: micahbarker_
Ali Wayman: aliwayman
IlaDerm: iladerm
Nick Gargione: nickgargione
Ion Austin: ionaustin
Morgan Welch: morgan__welch
elle jolie: ellesanger
Elizabethmoan: elizabethmoan232
: thisisjust_an
el: ellabroadhurst_
ky :0: kylerjohn.3
braeden: braedentidmore
Alberto Garza: agarz_17
Branton: branton41
E L L A R O S E: ellacotroneo
Simon John: simonkjohn
ally: allybellsnyder
~Grace~: grace_scarborough_
Tiffany Dinh: tiffanydinh_
gabby :): gabby.d82
Lilia_Oberlin: selena.bartholowmew
Michelle Taylor: malinda_taylor
: jt_shapiro10
jaylee weaver: jayleegrace_
Jennifer Drake: jennifer.drake.716
Bobby Ziff: bobbyziff26
Aves: averyrobinson__
Waterloo: waterlooaustin
maggie quinn: maggiequinn_
ASIA: asiaabella
Hector Muniz III: hectormunizz
joshua choy: 808.josh
Kai Robinson: kai_robinson11
Labeeb Ahmad: labeeb.mundrani
J Collins: jaeco17
odalys chacon hndz.: fries_chocolate
Jaslyn Umana: jaslyn_um
bebe irwin: bebeirwin
hyunho: tonylee1028
pommo: maddiepomykalski2
ELLA: ellameyyer
Abby Kelly: abby.k47
abbs: abbygathright
kate: kateaangulo
Manav Makhija: manavxom
R Y L I E: rylie.clark
ammad: ammad.hasann
Olivia Kate Ashmore: oliviakashmore
benjie duran: benjiedurran
harrison sager: harrison.sagerr
Carly Williams: carlyy.williamss
Julian: jujubeanbb
: preston3llis
hayden miller: haydengmiller_
Christopher Brent: chrisbrentt
: parker_massey10
: mae.erinn
ayden wicks: ayden.m22
adonis: theoreticaladonis
Prisha Mehta: prisha.mehta
Rylee Cooper: rylee_rooly
Shelby Rose: shelby.yeary
NinerMagic: __ninermagic
Jahggar: jahggar
Cannon Windsor: cannonwindsor
william: williammathews_
Katelyn Oelze: katelyn.m.oelze
Alana Cenaj: alana.shqiponja
Marquis Flores: back_fail_spamm
KARSON HAELZLE: kkarsonhaelzle
avery velasquez: averyy.danielle
Abi Pak: paabi.k
conner escobar: conner.escobar
Roman Orsini: roman.o
Nora Leal Troxell: n.oratrox
Proverbs 16:24: sydnie.elaineee
Marcus Grimes: semirgsucram
Gil: swimcoachgil
court: courtneyyconnor_
mihir safaya: mihirsafaya
Arki Valdy & co: arkironco
kendyl: kendyl.renee
Jojo: tsunami_papi_jojo
Brynley Ballow: brynleyballow
Maya Walker: mayajwalker
Isaiah Mitchell: htx.bigmitch
Tatum Eades: tatumeades
Travis Sykora: travissykora_
blake: blakeley.lewis
: kav.005
Lexi Robinson: alexissrobinson
Maddie: maddielowery_
Jerome: jerome_kai11
Elorra Wilkins Brewer: sewmuchlikeme
Eva A. Littrean (ee—vah): misseval
JJ: juu.bento
: kayli_sheets_
: jackii.sanchezz
amanda kell: amandafaithkell
hailee nevaeh <3: haileenevaehh
Bonnie Rodriguez: bonnierodriguez1
Emily Estes: emilyestes22
JZ: jade.zoller
talia giannini: taliagiannini
Coralynn Cole: cora_god_and_photography
Tiffany Alameda: tiffany.alameda
Taylor Walker: taylorwalkeer
: rickbeltrann
Villas on Rio: villasonrio
maddie: technicolorgarbage
A'Jahnay Nayy: nayy_babyyy_
Angelica Salinas: ansalinas1725
Fizz at Texas: fizztexas
Cameron Loyet: camloyet
JackHott: jackhott33
Lauren Ligon: laurennligon
Maya: maya.batra
MK: mkmaisardana
Austin Senior Photographer: graysonreesephotos_seniors
Rowan Brumbaugh: rowanbrum
John Wood | Country Music: johnwoodmusic
Sam Warden: samwardenn
Harshil: __harshilxo
Maloree Kuhn: maloreekuhn16_
Anthony Pizana: anthonynpiz
aaron marmolejo: aaron.marmolejoo
Firas Rachdi: rachdi_firas
Rafael Nicácio: rafaellnicacio
bradyn riley: bray.yates
: pistoy4
baseballislife03: baseballislife016_
Steven Mascolo: steven.mascolo
Daylon Bergeron: daylonbergeron
hayden bennett: haydennbennett
April 8th 2022: padre7361
Alyssa Osorio: alyssa.anahii
PATIO: thepatioapp
Remy Tran: r3mytran
Young Jflow: jalin.6
Terri Thomas Herring: terri.herring
Rinkesh Patel: rinkesh304
dothemost: gonedothemost
Jessica Coley: jessicaacoleyy
Nathan Heilbrunn: nathan_heilbrunn5
William: anonymous_30000000
austinfoodxvibes: austinfoodxvibes
: jsherman212
soph : ): sophie._.broom
: sammysmith.11
Mason Ibrahim: masondibrahim
Teja: teja31964
OSANCE•: iam.osance
: ilhpwcmtob
Taylan Silva: taylan.silvaa
Hitch, At UT Austin: hitch_ut
Luis: laguilerao
Henry: iamhenrycoughlan
Paintings By Min: paintingsbymin
Lissy: lissyk52
Dan: etluver
Cami: camilegarcia247
Arvis Miller: arvis_miller
Ivy: i_v_why_
Jane Ivey: jivey18
Jesmin Simon: jesminsimon
ZeeMee: zeemeeapp
Sebastian Montano Contreras: sebas24mc
: dainaylor
: isnisdb
Christian Giordano: cjgoalie19
Phillip E. McAllister: koolkountry
Valentin PD: j_valentin89
Abdelrahman Gohary: abdelrahmanelgoharii
Tyler samuel: tylersamuel3721
The Castilian - Austin, TX: castilianhall
Soledad Anita Flores: a_need_a_favor
Bernardo: bernardofp7
nlcw8: nlcw8
aline: spectraaline
sajid13001: sajid13001
BlingBottles: blingbottles.college
lucy hamre: lucy_parkerh
: ayank_han3901
C H E L S E Y: celery_shoes
ACD_plays_music: a.cd_music_journal
Chrissy: sivad4plus1
Charles Finster III: wessmithiii
Sudarshan Giri: sudarshangiri007
Heather Goodman Finley: lipstx4evr
Yanky Schuler Patrick: yankypatrick
Panji Akbar Sudirman: sangpetualanggg
PISTO FF: pisto__ff
Feso Africa: feso_hairclinic
Ks Aofkong: 9aof_kong9
: x2022abilx
utbeauties40@yahoo.com: utbeauties
Ranjeet Prasad: ranjeet.1902
Muhammad Yusuf: yusuf_19
Johnny Hix: johnnyhix
............: rozbeh.m.125
: zaymoneybags101
Yustinus Ruharawan: ruharawanys
Riyonk: riyonkkeling
: uninterestingbarofsoap
Ethan Price: ethan.cuh3
mohmed omr: lartarabe.studio_art
Mainul Islam Reza: mainulreza1
Muhammad Faizan: muhammadfaizan3775
asal: asad_papi
Lorraine Vazquez: lboogs216
: mhsa1.24
ella: ellaf.w
francisca: pochimafla
: cilii_037
Tutor Michael: essayprotege
Bella: isabella._.clover
Afshin.m: afshin.m781
: juel5087
Mompremier Real Estate: realestate.geo
Tonii Román: antonyroman32
Zaheer Ullah: zaheer.ullah.35912
Sana sana: sanabig2
FrozenRobot: tolathanyou
Ftouhi Noureddine: noureddine_ftouhi
mostofa sobuj: sobujmostofa
Bastian: bobbybastianjhon
anmol gupta: guptasports_
khan420: khan420725
: frye.nation
caroline: carolinesharplesss
monamohamadi: monamohamadi415
Patricia Carvalho: patycarvalhomakeup
ramesh kudecha: ramesh_kudecha
zzzz: 9370_evgenii
: gul06_16
: sark_ar4085
amir: amir_m312
Ibn E Adam: shahqamar00
Chaon Sarkar: srichayon
Md Nojim uddin: uddinmdnojim
Mehebub: mdmehebubhasan802
Lucky Akter: soudiyasubah
: x_anime_tronick_x
: rola.rola.hj2
: mahmuda902331
Perrine: perrine8411
Rafsan Ahamed Sumon: rafsan_ahamed_sumon
sem shahid: sem.shahid
gilana9076: gilana9076
mohin: mohin9968
Md.Sagor: md.sagor936
Ch Umair: umairch767
hussin369hs1: hussin369hs1
Lang-touna Ezechiel: langtounaezechiel
Sp Emon: spemon292
Adrita Binte Esha: adrita_binte_esha
mdsohag: sohag_no_03
Shakirpt1: shakirpt1
: hussin369hs111
sorif: sorif2222
Rokon: rokon7662
: mon.aa7070
Rajesh Mishra: mishra25rajesh
simran: khan1990simran
fatima: pakasharraz2021
Anonymous578: anonymous_48903
m: mari.1373m
mahmod: mahmod_hesami
: ujjol570
m wajid ali: amwajid564
anas: anas.ansari5579
Dennis Jay Cutab Segarra: dennisjaysegarra
M Anwar Kamran: manwar.kamran
jack: jack33333334
Asif bin: asifbin2
Akshe090: akshe090
peopleredemptionparty: prplagoschapter
Muhammad Ali: mobileshop2910
: waqas_1255
Al Mamun Islam: almamun8281
abdulrashid.362: abdulrashid.362
Niwat Rnt: nong_u2
Alamin75: ala.min4765
Ganesh Bangla: rock_star_gani_5
Md lavlu Islam: kaku12514
Fariezal Adhi: sales_daihatsu
sumon: sumon566667
salmaniac_yeasin: salmaniac_yeasin
: lyus_i444
shahali: shahasifali206
md Fahim: fahimfoysal74
hasnain.ali.4216: hasnain.ali.4216
: mhsa0_097
: samakova44
: dinanaanggelita
Muhammad Waseem: muhammadwaseem5530
Carroll: ca.rroll4994
Madhu: madhu36595
mahek chahel: chahelmahek
Yahya Baloch: yahyabaloch663
: irtaza208
Amna Ch: amnac.h123
: ayubmim90
: baharak.joon.2211
Donia: do_nia16
Donald Baker: donaldbaker5314
cris: crisss.2448
: yasin_biswas
Vusi Luthuli: t_sway_vee
mriana: marianamariana256
: sank.han34
sedois7557@gmail.com: sedois7557gmail.com3
: ulinurizhenishbekov
Babar Ali: babarali34450
Tracy Nagawa Teddy: tntuganda
pujabasak: pujabasak112
okokok: khan_khan7327
obaidur: obaiduri773
1Mpranta001: 1mpranta001
: ilgar.arezu
Lora: lora_adam889
Tanaz: tanaz_abri
Andrei Cercea: anderi_mihai_14
Kris: kristi___199
Deonne: deonne8395
Nayem Sadik: technical_nayem25
Ay Man: rotlot131
Omer Dar: dar_omer
Richie Raclaw: rraclaw20
MD Taijul Islam: itaijul887
Rose: roselxfbhcudo
Russell Hussain: russellhussain8
arslan_567: arsl_an567
mhamsu454: mhamsu454
Carol: carolwrightprazbxojba
JoAnn: jo.ann2187
: torkihoyre
shadikoon14: shadikoon14
Meredithe: meredithe3386
wajid ali: wa30884285
Shihab Sarder: shihabsarder245
: froza4866
aqeelmalikk207: aqeelmalikk207
BOOMER LEE HOMES • REALTOR: boomer_lee_homes
siamra: siamra6780
: towsif_ashrabi
Mehejabin Mokta: mehejabinmokta
Margeaux: margeaux4803
: ttanvir94
tara: ta9931rane
riponmia: ripon.mia34
Jo-Anne: jo_anne5528
Melony: me.lony8566
Karan khan: khan_gey
: sahi.n2543
premanshi: anshi.agarwalla
Renan Ferreira(Mini messi): yuno.trembala
Janeliya jenea: janeliyajenea
nurkarim: joynercrelo
Tayyab Ali: nomishahzada822
.: continactiv._a
Blossom Angel: hamiy1
Muhammad Ali: niceboy543333
: malak_w552
Ronnica: ronnica5182
Olivette: olivette5130
Winnie Akinyi: akinyi4947
areesha khan: areeshabm499
RUSLAN OR KSENIA: ruslan_or_ksenia
: dmitry_shuldeshov
: jia12984
: likhon3027
Marietta: ma.rietta7665
Hamza Awan: awanh7460
: rabulamu
Javed: javediqbl337
Taijul Islam: taijul516
Yasin Arafath: amdyasin927
mogahed ishag: mogahedishag
: jore2720
: c4ituxx
Raham: rahamalibugti491
: bukhsh114
Margette: margette147
Eugine: eugine5083
EdgyTheory: edgy_theory
MD Komol: md.komol.9847867
akramul.islam: akramul.islam6
: anummalik329
Fathi Ghazzawi: fathighazzawi
ALIYA OWAOMA EWERE: aliya31810
shadikoon14_1: shadikoon14_1
aii: aii.off.24
Mouhamad: mouhamad4994
: alam.in22
Rakib: arrakib_02
: farimafaisal890
fardin: fardin.636
: saha.rtaabaar
houtankhajenouri: houtant8888
Selcan hatun: selcan66777
Afia Sultana: afiasultana2688
Steven: steven_heyward1
: srdjan22858939
Betsey: be.tsey1310
: amirmohammed.b76
: saripm370
vansauura: eetass99
. .: _golomb___
mmosa#: mmossassyfipoor
Azlan Junaid: azlanjunaid535
Md Fojle Rabby: mdfojle.rabby.581
Heron patlal: gahd.gah
Ihsanul Haque: ihsanul107
Imran: imran99739
: babubd302
juliet: ju_liet7221
JhonPitter: jhonpittx351
Netta: netta251
: gatbah8
Richard: richardrobinsonjyqkfgfcli
: ateferahmani220
stafahlimajalengka: stafahlimajalengka
hadar369am111: hadar369am111
adnanhabib: adnanhabib814
ahmed: ahmed_ali8580
Maysha Islam: mayshaislam1998
hafeezbaloch: hafeez_baloch09
: tara_m573
prosonjit3344: prosonjit3344
Sandra: sandraadamsgpjmwwhinl
samiya Usha: sahnajansa
Md Shakib: siyam.abrar.56
: ara.sh9047
: tahaaaaj6
Sadie: 6114.sadie
Nancy: nancyleedwksbgstli
Erda: erda4015
ram kapoor: ramkapoor6133
Donna: donnaharrislpjngivktk
Sarah: sarahcampbelllybqwjtrph
hanjalashelkh4@gmail.com: hanjala109090
Mikhail Sasha: mikhailsashavera97
Thomas: thomasdavisnolywkncvj
Sarah: sarahlopeztkqbgxkmbx
Abir: ah2932304
samin._. 1400: smin._.1400
meezankhan: meezankhan394
: mayya13791
: feri72ferferi
: rag_bro
: kassanntri
: ward369gh2
: taham6017
raheem: alishahkhanabcdef2021
Lurline: lu.rline6298
Moshrrof: shaikot408
Krysthal Marcano: krysthal_0910
Mario Pillco: mariopillco_19
Abdullah khan: khanabdulah2233
Oralle: oralle697
Michael: michaelevansvhcnznerds
imrankhan: imrankhan07175
: alipor138479
Kenneth: kennethmillerukjlsfcufm
: tamoor.raza37
AMBASSADORS WANTED: empire_william32
B Evi: ukinmydna
nazi_66: nazi_60_10
: hasibul.saad
: frost.sfk
: bahar_o71o
asharvinpius: asharvinpius
kylie: kyliejesssjv
Md Mahim: mahim4620
EduCrack: theeducrackapp
: mrsajjad866
akash 20: akash20267
mdsuvokhan: mdsuvokhan2
arefin shihab: shariarshihab221
saranaimipuri: saranaimipur
: tahananvazade28_
asad_jaan_567: asad_jaan_567
Jannat Mirza: maria_jan_1995
rahena khanam: khanamrahena
: rakibkhan3737
Taqi khan: ktaqi2337
Enas Bo Naser: enasbonaser
amir202081096: amir202081096
asif khan: asifkhan0349
sabbir: sabbirahammed.n.k2021
: yousef369th4
lutfun: mstlutfun89389
8ce234d2e2: 8ce234d2e2
Richard: richardwalkeregcxyfisgn
xcom: xxma_n34
sammi chowdhory: sammichowdhory
SujonHossen: sujonhossen1306
Kopa samsu 2: kopasamsu2
KHALID HUSSAIN: khalidhussain6770
Kevin: kevinmooreyaesdbqvju
: dmidri_alekseev_____
abdur: abdurrahman976534
Jason: jasonwilliamsjtxfyczbbc
Christopher: christopheryoungpqdzvttaew
JimmyNeesham: jimmyneesham472
Sandra: sandralewisfychdkrptd
Mahabubul Haque: mahabubul93
MEHEDI: me.hedi3447
: 1ayankhan1
John: johngreendafhozzbxn
marinaafran: marinaafran2
: claaima
: saaaraaa.alaee
M Amir Shahzad: mamir8611
: kashdoctor3028
Sharon: sharongarciaczzwpxbflw
: mehdimahdiantalab
KamrulOne: kamrulone
: kabu.com.008
Jennifer: jenniferrobinsonlmzgnvekbl
: walaa369gh44
: essa369ah111
Saimehasan: hasanmahfuj34
TasRif Asha: tasrifasha
Rahul Kumar: rahul5279kumar
poyan: poyankhan1y
: jibon12321
Daniel: danielkingqofwixdzaw
Anthony: anthonygarciavdqdgnsxpt
: salmankire7
arar: araradore
Donald: donaldcollinsbbifxktcja
Sabbir Hasan: parulaktar010
Husnain Najeeb: husnain_najeeb7462
: sara.sara9932
: tuhin4455tt
Helen: helentaylorhygtppjdvt
sanaullah: sanaullahs36360156
cpt: cpt605
Susan: susanhernandezxxebsgyrbo
Lisa: lisawilliamswrfpfgkaqy
Laura: lauramillergfshwiwylp
Quique Na: naquique
: zame.ermemon
mahi_thoughtz: mahi_thoughtz
Linda: lindawalkernvocoqgzmb
shirzad2o5643: shirzad2o5643
Dorothy: dorothywilliamstenbbhkood
Jeff: jeffparkerhgnuklmsvs
Steven: stevenwalkermxbrembeux
Christopher: christophermartinezsdphuflxsl
: pagal.015
Hk Siam: hk_siam1
Carol: caroljohnsonoghnhgmbok
Sathi aktar: sathiaktar4360
Patricia: patriciasmithaldawlihep
zeeshan: zj1655054
rida khan: krida6258
Donald: donaldrobertsbloxcbslom
Susan: susanbakerxoyzuyjbyu
: hamza.10000000
George: georgehallkuadgjnoce
meroz: merozali899
: qazishoaib00
Sandra: sandramartinweaglgdcas
Shahid Rock: shahidrock71
Nancy: nancyadamsibnqfzposa
Charles: charleshalldydzsqoypz
: hina13445
John: johnturnerwfsprskrsu
tajk_999: tajk_999
: hemalraya3
Mary: maryrobertsvwfsffbvwa
: asifk.han1098
ZH Hassan: asadzh962021
Elizabeth: elizabethkinghvwrszjqhm
Baby done: babydone702
Mark: markperezqbolpaycba
Michelle: michelletaylorhknpkdsdpr
Ali tehmoor: ali_tehmoor_3029
Nizu M: nizu6991
: themaster5373
Kevin: kevinbakervdjsggcyfc
Naveed Ali: naveedkhaskheli2018
: aizaakram20215
: chandi6158
Shah Sabiur asif: shahsabiurasif
Ruth: ruthscottjduttfvbal
: meti.boyka
: shoaibhasnain50
: mnbvcxz45902021
: hsi23677
Rasel: arraseladnan2021
Kimberly: kimberlycollinsscfyssyedw
Nancy: nancydavisvqrmnzznpx
Jason: jasonlopezwlzzaogewa
: jana36938
zafar: zafar03000
: kgmahna
lisa.mfm.1: lisa.mfm.1
Margaret: margaretdavisrsmbyjaewh
: mdde_lowarhossen
behnoush.fan: behnoush.fan
Wajid Qureshi: qureshizadah
