william: thebillymcnamara
Alex _mail: _mailalex
Karla Boussart: karla_boussart1
Maryam: maryamelbeltagy
Annika Hesse: annikathesse
Leonardo Garcia: leojgarciap
Allie: alexandragajak
Jaidyn: jaidyn_b15
taco :p: bela.davilaa
summer :): summer.fugere
sof: sofiefinch
Emma Elizabeth: eliiizzzabeth33
Mary: maryccreel
camille gm: camille_agm
Donna Waitkus: donnawaitkus
Univeristy of Florida: ufclass_2026
Carlos Hinojosa: _carlos_hin0
myles: myles_awayyy1
Gabriella: gabbycarvelli
Gabriel: gxbe.ee
lexie miller: lexiegmill
hailey!!: hailey.mp4
Alex _mail: _mailalex
Karla Boussart: karla_boussart1
Maryam: maryamelbeltagy
Annika Hesse: annikathesse
Leonardo Garcia: leojgarciap
Allie: alexandragajak
Jaidyn: jaidyn_b15
taco :p: bela.davilaa
summer :): summer.fugere
sof: sofiefinch
Emma Elizabeth: eliiizzzabeth33
Mary: maryccreel
camille gm: camille_agm
Donna Waitkus: donnawaitkus
Univeristy of Florida: ufclass_2026
Carlos Hinojosa: _carlos_hin0
myles: myles_awayyy1
Gabriel: gxbe.ee
lexie miller: lexiegmill
Senior Shoutouts: seniors.shoutouts
Scottish Rite Dormitory: utsrd2026
Alejandro Lopez: _alejandrolopez4
: phoebe.cosgrove
evelyn lee: _.evelyn.lee._
Rosalinda Perez: rosalindaperez4002
Allison L.: all.is.on56
Emerson_Joy: emerson_fuller10
Melanie Charron: mel_charron4
jordan lovoi: jordanlovoi
Hector Mendez: that.one.guy.hecto
Ally: allyyjewelll
Charlotte Eades: char.eades
arielle: a.ria.lle
: princesssdiariezz
alyssa lane: alyssalane._
caroline: sugarspiceandbadadvice
Anna: annagreen04
l i a: lia.hoang2022
Austin Gardner: austinthescholar
Natalie Fetter: nataliefetter27
Sudiksha Gudipati: snereksha
Olivia Gerhart: livibeannn
michelle: michelleeerivas
Engelberus Joosten: sjeng_van_menkes_driekes_ties
Stephanie Calderon: stephaniecalderonnn
Tommy Pope: tommy_pope5
Alysa Madriz: alysamadriz
Christoph: christophxklein
gabby: gabbybesnard
Breela: breela_m
amadeedee: mommadeedeee
Emma Nagle: _emmanagle
Waamene Yowika: imsognarly
S O P H I E P A S C A L: sophiexpascal
Sergio: sergio.t__
Betty Weaver: bettyweavertn
bella: bellsdom
Ruben Parra-Cardona: parraca1
Vaishu: vaishumarreddy
Sarah Catherine: sarahcatherinecrow
Cesar Picazo: cesar.picazo88
avery schilling: aveschilling
Ashmit: ashmit195
Abby: abby.n26
Gabe: gcweaver03
vashed<3: vashedthompson
Ty: ty_wilson29
Yasmin Jenna Jackson: yasmin_jenna_jackson
Mary Nelle: marynelle_cravens
Zach Arenberg: zarenberg21
tatom: tatom.hoffmann
Isabela Salazar: salazar.isabela03
Srikar Sadhu: srikar_sadhu
Samantha L.: sam_leidel
Emma Centanni: emma_centanni
Tere Parris Curtis: terecurtis
Sophia Brod: sophia_brod
halle schenk: halleschenk
Dani Rose: danimirin11
Lizzie Coyle: lzcoyle
Madelyn Leonard: madelyn_leonard
: bonesjames1999
Daniela: _daniela_2624_
Deba Osague: deba_osague
Kimberlyrobin97: kimberlyrobin9797
Ali Zaidi: alizaidi_04
mahek dodani: mahek.dodanii
Juan Granizo: juan.granizo
Cash Ainsworth: cowboysandhorns
celeste olivarez: ccelesteolivarezz
Kyeongseo Choi: 04kyeong
kennedy renae: kennedyrenae_
Likhita Velmurugan: likhita_v
Rylee Roe: ryleeeee_r14
anusha singhal: anushasinghal_
helaina gilmer: helaina_gilmer
gaby zurita: gaby.zuritaa
isabel redwine: isabel.redwine
Jaylen Waithe: datkidnamedjay
Heath Harris: heath.harrisss
Sarri: sarrionna
D A N I E L A: daniela.torunoo
Alejandra Acosta: alejandraacosta_17
melissa: melissaa.tran
•Meredith Rillera•: meredith.rillera
Christy Lovoi: christylovoi
Tate Elfarr: tateelfarr
kenady: kenady_cooley
Amy Thoresen Goforth: fourgoforths
Tiana: tianawang05
Mahrysa: mportales22
anvith: anvith_reddy666
saboor ahmed: 1saboor_ahmed1
Sydney Frisch: sydneyfrisch
hailey smith: hhaileyysmith
emma cate: emmacategall
rebecca: rebecca_oladejo
Martin Mulinix: martin_mulinix
: _._jinna_._
marly shawky: marly.shawky
~WHITNEY~: whitney.shayfur
Anna:): adobre25
Rene Cuellar Jr.: rene_cuellarjr
Julissa: julissarojass
Ben Hamel: benhamel1
Adnan Allan: adnan.alh74
krissa:): krissajhaveri_
RyAnne Rovelo: ryannerovelo
Kaitlin McIlroy: kaitlin_mcilroy
Ellie Hague: eahague99
Esteban Elias: ea_elias02
Nehir Aran: nehir_aran
hannah: beanerkween
support the orphans: mwesigyajohn2
Katelyn Puello: katelyn.mia
Gini Dyer: ginigdyer
Lauren Jeanes: lajeanes04
samantha: samanthawlodawsky
Ishmael Dickerson: lowkey_ishy
brody dickson: brodypdickson
mairany: mairrany
anjali :): anjalicherukuri
Brad Joseph: bradjoseph03
Meggan Leonard: megganl16
gracie leal: gracie.leal
Saidynvasquez: saidynvasquez12
madisen lieberman :): madisenkate04
Cj Atchison: cj_atchison
Christina Balboa: christinabalboa_
Hannah Wehofer: h.wehofer
alexa: alexanuncio
Paige: paigemeridian
Robbie: robbie.valcarcel
: isha.ramann
sara kate !!: ssarakatee
Sara Hickman Ridder: sararidder
Jordan Norris: jordannorriss
Nikolas Parker: parker.nikolas
Makaila Van Buren: kaila_vb
EMMA GRACE ALVEY: emmalvey
: kynadi.jones
makenzie: makenzie.long17
Austin Raben: austinraben
Greg Navarette: gregnavarette
becca :): beccabeinart
sophie kolbe: sophiekolbee
Savannah Rakowitz: savannah_rakow
amita: amita.satish
Amir Kian: amirkian_.info
Will: will_29455
Cherie Dexter-Grishin: cheriegrishin
kyrielle: kyrielle_1
Noah gee: ngee2025
Ryland Marshall: rylandm23
Lucienne: lucienne.moran
Brianna Clinkenbeard: cli_nkenbeardbrianna
Dusty Davis: lad_davis769
Leviticus Gay (pause): luckyleviticus
Isa: isa.kazen
ave;): averyy.raynee
Naysa Leach: naysaleach
Varun Vedala: varun_vedala
Jenny Cope Warden: jennyw6
sydney!!: sydneyyfulton
Ashley Metz: ashleyrblanco
Ayush Sheth: 1006ayush
Megan Lam: megandlam
libbie brown: _libbiegrace
Aadhav JaiMurugesh: astroaadhav2004
: mshea_28
luna: lunareichert_
Dean Jeff Levine: dean_jeff_levine
hailey: haileyywilliams_
Jenna: jennaabulughod
emily: emilyygottshall
jas: jasmineeweng
Trevor: trevors.life
Sam Lu: presidentsamlu
Arjun Radhakrishnan: arjun.189
eesha vejella: eeshavejella
isabella martinez: isabella.martinez22
shruthidandamudi: shruthidandamudi
sabrina merkle: sabrina.merkle
lia bloom: lia.bloom_
Aidan Leonard: a1danleonard
Gabby Norman: gabby.a.norman
Sara Burris: saraburrisss
Nidhi Pabbathi: shelikespigs_
Ben Ridder: ben.ridder_
Sarah Dominguez: sarahhkarina
becca!!: beccabalan
Kezian Dunn: keziandunn
Ali Patterson: alissapatterson_
ania davila: aniadavila
abi: abigail.jolie
Omar Almeida: omar_almeida11
Caleb Geyer: caleb_wisemangeyer
Virginia: miavmiddleton
Eva Childs: evachilds
Julian Juarez: eltigredelnorte007
hope vanderburg: hope.vanderburg
Leland Murphy: lelanddmurphy
alyssa: al.yssamarie
Dennis Kim: dskim.331
Bella R: isabellaflorencee
Mayy Alsawfta: mayyalsawfta7503
Ricky Rodriguez: rick.mo.03
Olivia Swonke: olzswonke
Andrew Zheng: andrew.zheng_
ash manoj <3: ash.manoj14
Will Peters: willpeters03
Jack Staton: jack_stat0n03
Colin Angel: colinjangel
Anika Mittal: mittal_anika
Dave: dave.nwaneri
Abbie Boutilier: abbiebout2023
LittlePancakes: thelittlepancakes
Reeba Abraham: reebabraham
Allie Alton: allie_altonathlete
julia quigley: juliaquigleyy
shivani: shiivaniikumar
: drewcohen11
ava holt: avareneeholt
Alyssa Klein: alyssakleiin
Steph<3: stephily2
Jerry Wang: jerrywanng
Daniel McIver: thedanielmciver
Nathan Su: classicnate_official
Jasmine Lu: jas._.lu
Alexander Dunaway: alexander.dunaway
Anna Kate: annakatekelly
Harrison B: harrison_b4
• virginia nussbaumer •: virginia_nuss
heather hawkins: hsquaredcarebear
Morgan Marie Hernandez: morgan_m_hernandez
Emma Dencker: ecdencker
maya orenstein: mayaorenstein
lili!: lili.toledoo
sophie sorkin: sophsoph04
payton!: gwynnpay
betsy goodrum :): betsygoodrum
Natalie Jakobsohn: njakobsohn
Sharon Balinsky Grundfast: sharongrundfast
Valen Hunt: vhunt0307
Riley Schultz: therileyschultz
Maritza Miranda: maritza_._miranda
Ana Sofia Meyer: anasofia.meyer
Vince Smith: vincesmith_
Sofia Frey: sofiafreytx
ARIEL DOSS: arielmargaux
isabella !: isabellaa.34
Jenna Lindemann: jennalindemann1
LEXI: alexisdmalone
had: hadley.olsen
Ryan Sobol: ryan_sobol
Walker Francis: walker_francis
Lily t: _lily_t_0416
Mary Ann: mary_ann_peregrina
Emma: emma.nicole.m
Bibek Bajagain: bibek.bajagain
Elizabeth Garcia: elizabethlandrygarcia
Corinne Piorkowski: ccorinnep
jessica: jessicanorthh
Tori: tori__deawesome
kaydee torres: kaydeetorres0
emily long: emilymiriamlong
: eb5chico
Mina Jeong: _minajeong
: aarya.03
Shree Allada: shree.allada
Dishita Awataney: dishthefish2194
Kristi Griffith Quick: kristiquick_
Olivia McMillian: oliviamcmillian
savannah lavelle: savannah_lavelle
Elliot Mast: elliotman48
Jack Newman: cactus.jack03
Zachary Mead: zachmead97
Mason™: masonajones87
maddie: madisonnmcdowell
meygan <3: meygan.garcia
Jaqueline Del Angel: jackie.da
Amanda: amandathegallo
harrison: harrisonhensleyy
Tommy Brigham: tommy.54321
Delilah Garcia: _delilah_garcia_
Perise Sasa Siaosi: p.erise
Eliana: _.3liana_celeste._
Gini Michelle Ard Barton: gini.barton
Ana: anapaulakendrick
anna phillips :): annamichelleee
Lindsay Neil: lindsayn.04
Brenda Anzures: brendalizanzures
Jordan Cruz: jcruz4512
Hailey Garza: haileygmarie
Yuri Lee: yuriii_lee
Kenneth Garcia: kennethggarcia
Lane Johnson-Martinez: ginganinja2166
Lisa McDonough: mustangprincess13
margarita ovalle: maggieovallee
Maddie Mandel: maddieemandel
Ellen Sterin: pursefrenzy
ruby bixby: ruby_bixby
Jadrian Rodriguez: jadriianjay
: yousefkamall
Leslie Gonzales: lesliie_g13
emery whitford: emerywhitford
marlen: marlenjuarezz
dylan hauglid: dylanhauglid
mihika: mihikapatankar
Sophia Fente-Damers: sophia.fd
Rohit Rajan: rajansrohit
Jose Moreno: eljoseamoreno
Anna Beasley: annabeasleyy
Expert Writer: essayexpert68
brielle: briellelizabeth147
ELENA SOFIA: elena.c_
alex nabors: alexnabors
b r o o k s: beyondbr00ks
Jackson Smith: jacksondsmith24
Clara Carrabba: claracarrabba
Justin Thai: jstn.thai
Annika: annika.gabrielle
eesha: eesha_nayak
jC: bisou.j
Vivek Patel: vivekpat.el
Mikey Laderer: mikey.laderer
Mason Cox: masonmcox
Lauren Darzy: laurendarzy
Ruby Manley: rubymanleyy
Tabor Morris: talk2tabor
UT Forever Texas: _forevertexas
Kaitlyn Yacenda: kaitlyn_yac
UT Austin CAP Students 2026: utcap2026
audrey: aud.sperry
Isabela Salazar: isabelasalazar061003
Mario Ovalle: mario_ovallenzuela
Rohan (Rappin Ro): rappin_ro
Ellington Hull: ellingtonhull_
Lillie: lillian.kate
sophie cain: sophieecain
Zachary Stansbery: stansbery_zach
Emma Dobbs: emma.dobbs03
Idalee Grande: idalee_x0
nataly: nataly.oliv13
nat: natalieanspachh
x i x i: xixi.hillman
giovanna: giobustilloss
natalie: naatalie.d
Andrew Bohnsack: andrewbohn22
Aaiden Best: _abest288
sarah love: sarah.macjones
Angelica <3: angelicam.g04
grace: graceutter
andrea: aandreaortegaa
Natalie Carey Fielder: nataliecareyfielder
annika lærum: annikalaerum
felix !: ffelixjegede
Vik Gokli: vikgokliii
adrita raychaudhuri: adriitaa_
Psychic Mama: mediumpsychic01
Stargazer13: stargazer1377
regan walker: reganwalkerr
Maria Paula Aguilera: mariapaulaaguilera13
Will Mathews: therealwillmathews
David Wheeler: dwheeler7950
Gib:D: gibsondearing
jjzmmm: jjzmmm
: rahulabraham03
GRACIE: _graciekent
Harrison m: harrisomnurphy
taylor lin: t.tayyylor
julia<3: juliaraghu
Gray: graysencarlsen
Evelyn Sheahan: imevsheahan
Canon Gorman: canon_gorman
issa correa: issamcorrea
Ericka Dusek: erickadusek
nick n: n.ng04
erin :): erin_y_lin
Cyrus Bronson: cyrus_bronson
Elise Morrissey-Rocha: _elise_autumn_
Lilly: lillyredwine
laura: laura.merlina
:((: crystalsdelgado
Kimaya Meherali: kimaya.meherali
Upper Media Rentals: umrentals1
ricky: ricardoo.ortiz
Jennifer Fang: thejenniferfang
tori.: t.skitori
Jordan Borders: jdogblue14909
: jay.815
Andre: andre_yourstruley33
shyam: shyam_p1
lia: aliyahbelen
Casey Buchanan: casey_polarbear
Joey: joemerickel
Steph: stephaniemmurrayy
Austin: austin_friedman13
Evelynn: evelynn635
TJ: itstjkohli
Madhu sharma: madhuhhvsharma
maddie: madelynaolive
kennedy :): kennedy.a.baker
Selvi Shan: selvi.shan
keelin <3: keelin.finley
marin: marincroix
Lauren Wilson: _lauren.e.wilson_
Bryce Strongin: brycestrongin
Brooke Bingheim: brooke_bingheim
Audrey Wilson: audreyrwilson
Ava Picone: avapicone
sanjana </3: sanjanadandu17
Jordan Gwr: golden_warriors_robotics_8576
Matt Greenfield: greenfield.matt
alyssa lugo: alyssa._lugo
Kaila D.: kaii.dela
Halimot B: halimot_b
Sanjana: sanjana.sen_04
Nusaibah Arif: nuusaibah
luke: luke.blausen
: jacksabo_
Haydeeth: haydeeth__
E L I Z A C O N N O L L Y: elizatconnolly
Caitlyn :): caitlyn.snedaker
paige simpson: paigehayley.s
Reese: re_c
Ainsley: ainsley_nelli
Chloe Miller: cchloemillerr
Annika Philippi: annika.philippi
Anay Patel: anay111803
Mala Gupta: malagraceg
Rashad Adams: therashadadams
avery: averyengleman
ISABELLE GREEN: isabelle.victoria7
Adi Behre: adibehre
emily: _emilyboler_
Sofia Elisa Cabello: sofia_cabello3
kelly graham: kellyy.graham
VIV: viviankbrooks
gaby: gabygeez
Karen Patel: kk_3104
zafra <3: zafra_haque
Jana Madi: janaamadi
Inarra Ali: inarraali
Evan Craig: craigohaslosthiseggos
Kezia: kezia.grant
Imelda Delgado Trevino: amom_22_boys
: l3naaaaaaa
Alex Bellucci: looch_3
maya: mayapai_
brendan: brendanreynoldss
Orlando Rodriguez: orlando_6634
daniela osorio: _danielamosorio
Leslie:): leslie.rives
jess: jesssilverstein
tay: taylor_channn
Ava Acton: ava_acton
Leah Weisglass: leahweisglass
shree: shreeganeshh
Jeanne de Moucheron: jeannedm_09
Emma: emmaemigh
isabella: isabella.rosess
Gabriel Ochoa-REALTOR®: g0choa
Elaina Hamuy: elainahamuy
abdou petrolium: petrlium
Alexis Hansen: alexisahansen
tanisha padhi: tanisha_padhi
KEIRA YUKICA: keirayukica
Nico: nicolas_w00
teresa nieto: _teresanieto
vidhi: vidhisapru
mason: mdblalock
kate christoff: katechristoff
griffin harwerth: griffinharwerth
Juliana Sarria: juliana.sarria
Katlyn Huynh: katlynhuynhh
meredith: merf03
Aidan Lee Vargas: aidanvargas23
lauren lindemann: laurenlindemann_
khushi :): khushig29
crimsonxgold: crimsonxgold
Jasmine: jrmer_25
Kristine <3: krissycaridad
Cristian: ritardando.xd
Jennifer Myers-Wong: jmyerswong
Kylie Jo: _.kylie_jo._
bella margolin: bella.margolin
Amber Castro: amber.castrooo
Maci Lynnell Lowery: macilowery
: gonetotexaswanderer
carolina carrizales: thecarolinacarrizales
Adeline Trojacek: addie.graceeee
: callieabrady
Megan Fox: meganfoxtn
Salma: sallisal15
jocelyn: jocelyngarciabarb
evan dannenhirsch: evandalize
: nylaanderson_
Zach Adler: zachadler1126
Serena Syed: serena.syed
hello shawty: walker__blake
Joshua Allen: josh24allen
ANNA SCHLETT: annaschlett_
Sara Foster: sara.foster18
Elizabeth Conneely: elizabeth.conneely
hannah smith: hannahsmith_324
maggie mcfarland :): _maggiemcfarland
jasmine xu: jasminex.21
Tanzil Momin: tanzilmominn
Alexis Morales: ahh.lex.is
surina: surina.19
Madeline Jordan: _madeline_joy
rutvi :): rutvi_kunadia
Arushi Munjal: arushimunjal
Karina M.: _karina515
Georgia Ann: georgia.everetttt
Juliana Rocha: juliexotowd
SGT Rodriguez Christian: sgt_rodz_healthcarerecruiter
Rea ;): reaganwhitehouse
Saiya Palmer: saiya_palmer
Kennedy Bicksler: kennedy_bicksler
Addie Kimberlin: addie_caroline22
Ariel Hernandez: __ariel_h
fernanda herreria: fernandaherreriaa
Blair Sayers: blairsayers
Deborah Hardbarger: deborah_hardbarger
Riley: rileytendler
Tracy Weng: tracyyweng
Maya Akiva: mayaeden_
Katie Poulter: katieepoulter
manny: manny.delacerda
Jack Moran: jack.moran10
Nathan Pannell: nathan.pannell
Larson Crank: thelarsoncrank
Mary Whilden: marywhilden
paige patton: paigepatt15
Marla Evans Howard: marlah56
Chase Cangelosi — ATX REALTOR: chasingrealty_atx
: k.bhakta04
Brinly: brinly24
sandra garcia: sandrapaulinagf
chinonye: _simplyy.cc
A-Y!!: _ahyoungkim
_cali_princess: _cali_princess
Abby Daehler: abbydaehler
Kristal: kristalnicolee_
Hannah: hannahhstevenss_
ainsley:)): ase_722
abby kremer: abby.kremer
k r i s: kkristenharris
Tyron Swinton: tyronswintonrealtor
Adam: adam__ily
aidyn neiman: aidynneiman
angie blair thorpe: ang_thorpe
Leah Plowman: leahkplowman
Eva Gormley: evagormley
ciara <3: offbrandecici
Valerie: valll_770
KosMoEthnicFashion: girishku007
Kaineuche_1323: uche_chukwu_1323
Jessica Mikell: jessica.mikell
Zeynep Ertuna: z.e.y.n.e.p_22
Briana:): briana._.zuniga
Ean Hamric: hammy51_
Yadira: yadira.vega.0024
Kobe: kobechronicles_
Samantha Lee: samfaithlee
Jennifer Drake: jennifer.drake.716
Nicole Seiler: bedazzledbottlesnicole
Marely Hernandez: marelyh3
Josh McKenna: joshua_mckenna868
Lourdes Cabrera: louccabrera
Mia: mia.latigo
: andrea_gh4
maryam: m.m_613
lily: lilybrundige
dani: danielaipatino
naina dhawan: naina.dhawann
isa: isa_garzaa
Nathan Zachariah: nathan.zachariah
Roger Rodriguez: rogeodriguez25
lex!: lexjoness_
Lauren: lauren.lambrecht
Nate: natebroidy
Leila Rabah: leila.rabah
nat: natalielongacre
Allyson Rodriguez: allyyy_rodd
anna montgomery: montgomery.anna
Michael Lopez: michaellopezut
Lexi: lexigrace.22
Jennie: _jenniebonnett
jules :): julesmurillo4
Char <3: c.mankinn
Sofia Di Salvo: sofia_di.salvo
Lily Kent: lily._.kent19
: jacqueline533
Samuel Brack: samuelbrack_
Jorge Rivera: jorgeriveratx
olivia gibson: luv._livv
LAUREN!!: laurennllucas
ainsley burns: a1nsleyburns
mimi <3: milicakonatar
Laura: _laura_baker_
: kaia.radloff
Stephie Sam: stephie.sam04
Taylor Gardner: taylorgardnr
aj gamez <3: aj.gamezz
Jack: jackbdixon
JJ Humphrey: roughy_90
Andres Felipe Robles: robles_cb
rabah: rabahanwar
CUTE CUSTOM COLLEGE APPAREL: sororitysc
william: williammathews_
katie roque: _katieroque_
Julia Franz: juliafranz5
Liz Gateley: lizgateley214
lily: lilycoannn
christine gerhard: christine_gerhard
Paulina: pauuvictoriaa
N O A: noamoore
SARA ABDOLI: saraabdoli62
amanda: amandafoy_
Dominique Maldonado: dom_._._marie
Arslan Ahmed: arsal.ahmed.77
TyErica Gill: tyericagill
Roro Imarah: roro_imarah
Shawn Berger Hickman: shawnybhick
Erik Segura: erikseguraocean
Luke Boxwell: lbox22
Les: leslyyy_cruzz
Brooke Rogers: brookerogers08
Gabby Aguilar: gabby.aguilarrr
ayden bell: aydenjbell
anne: anne__porter
MinhKhang: minhkhang15nguyen
khalil :)): _khalilmalik
Maria Tortorelli: maria._trt
Mehdi Ghasemi (He/Him): mehdi_ghasemi_1990
Sammy Yoder: yoderryoderr
jada kabani: jadakabani
Jacky Casey: jackycasey
: 0liviaperrin
rushil: rushling18
jacqueline saenz: jacquelinecsaenz
CHUCK G: chuckg394
Diego Recio: d_recio77
Adam: ad.am5141
christianna m.: chr.xssy
: zairakabirr
Melissa Spetkar Zelin: melissazelin
chris lopez: nuychris
Libby: libbymtempleton
Abbie Valdez: valdez.abbie
Hailey Lockett•: hailey.lockett
Pranav Jaganathan: pranavjaganathan
Michael Ibarra: symphonie.17
Maddie Savasky: maddiesavasky
caroline cullen: cvroline
Kevin: kevinscontreras
Anish Doshi: anishdoshi04
kiya: akiya.b
Austin bartlett: abartlett24
Lilly Triandafilou: _lillytriandafilou
Zachary Hyett: zachhyett43
chong :): elaina.chong
SSG Elliott: ssg_elliott_army
aynoa casavantes: aynoa.c
•jessica jewel tidwell•: jessie.jewel
: amandaharrelsonn
Cody Hall: codyhalll_
nataly: natalyoviatt
kate: kateaaguayo
Sophia Sandoval: sophiasandovall
Dane: dane11175
Mia Wurster: miawurster
Filza Momin: filzamomin
evanuel: evanhho
Sommerlyn Babineau: sommerlyn.s.babineau
vivian montoya: vivianmmontoya
Georgeanne Cullen: gigi_cullen
Kamid Lozano: kamidlozano
pri: bittersweet_pri
jonathan shoe: jonathan.xu
Samantha White: samantha.janelle
Abby Grosshandler: abbygrosshandler
olivia gonzalez: olivia8gonzalez
Katie Morgan: katiemorgannnnn
Matthew Smith: mmatthewsmith
Audrey Kirwin: audreykirwin
Aubrey ShyAnn Clayton: aubrey.shyann
Maddie Paige ™: madell._
AVERY: averyschwartzzz
mesch: kendra.mescher
Robert Ybarra: official_ybarra024
emi: vdzemi
kooper kohut: kooperkohut
Raleigh Ward: raleigh.fw
Traci Deering Neiman: tracineiman
Emily: __emilybray__
kirsten: kirs.ten909
Anna Love: anna.clove
Eddie King: eddieking1836
: josleeen_
NOA MILLER: noamillerr
riley kate: rileypracht
Kimberly Stern Robertshaw: kimberlybobshaw
krystal <33: krxsta1
chris a-mayonaise: some_stranger_2004
sam: samantha.hailey18
: levii.robinson
Trinity Brimelow: trinitybrimelow
egya reddy: e_reddy19
Lauren McKay: lauren.mky
Nathan Safranek: nathansafranek
ry!!!!: ryahmhill
Destin Drummond: dezdrummond
abby: abby_hecker
Ion Austin: ionaustin
clojo: chloeee.lewis
Mason Tucker: _mason_tucker
Skyler Michele Witt: skyler.witt
sanya_lalani: sanya_lalani
Mateo: mateomtaborda
Raiyan Amin: stunnasaad
Dariel Naval: itsdarie.l
glenda noemi: glendadiaz381
Makena Faltysek: makenafaltysek30
Lacoda Davis: l.davis3
Hallie LoFrisco: hallielofrisco
Hayley Wetzel: hayleywetzel
Anna Nowlin: annakellynow
sammy: sammy.weinn
Samantha Dworaczyk: samantha_dworaczyk_
lily gribble: lily__gribble
izzy b: izzybba
astrid a: astriidaranda
l i l l i e l o o s e: lillie.ann_
: pardapear
Emily Schottman: emschottzy
brooke barron: brookeebarron
elle jolie: ellesanger
Mihir Asnani: mihir.asnani04
Danelo Ibis Gonzalez III: danelo_g_3
Alex Scott: aluke.scoot
maria: avocadosarehealthy
Ella Love: ella.love
Austin Senior Photographer: graysonreesephotos_seniors
Jacob P: jacob_palm5
: avabarrera
Sadie: sadesandsmiles
emma: emmaaamoncur
nathan borshell: nathanborshell
Finn Warren: finnwarren_
Evan Leeper: evan.leeper
: marvizzworld
Sophia: sophia.3100
A•D•D•I•E: addison.kate75
Mahdia Rahman: mahdiaaa._
skylar stepp: skylarstepp
Analuisa Castellanos: analuisaaa.c
m.: marianaabenavides
Bryan Omodon: bryanomodon
Serenity V: versai777
Megan Le: meg_le0210
Monique: monique.1031
Sofia: sofia_fuller
lucy hamre: lucy_parkerh
nelly (taylor's version): whoaaanelly
Julyssa Cantu: julyssa_cantu
beth dvc <3: beth.dvc
J Flesher: josflesher
Ramsey Perez: itsramseyperez
mikey gavranovich: mikeygavr
Caden Christian: caden_christian
mercy.arely.solis: me.ar.so
mireya !!: mireyamedel
Johnny: johnny_boiii25
: bostonuniversityclass2026
SaDasia Williams: sadasiawilliams
Antonia Ferriol: cieepalma
Ryan Spier: ryan_spier
Ryke Allen: __ryke__
Sári: sarigonda
R Y L I E: rylie.clark
Emily Timmons: _.emily.timmons._
Talon: talonblottin
Carson Flanagan: carson_flanagan_42
Dayton White: _daytonwhite
Joseph Gomez: josephgomez__
Dickson Addo: dickie.addo
David David: davidwdavid
Aliyah Banerjee: aliyah_banerjee
Joe Jordak: j.jordak
piper: _piper.elizabeth
katherine: katherineethomsonn
Michael Berman: michael_berman16
Shawn R. Campbell II: romell_vibes
BELLA FRIEDMAN: bellafr1edman
abhi bandi: robbypattyfan
Hulke Designs: 5hulkes
Ahmet Ali Mert: ahmetalimert
Sari Shenkman: sarishenkman_
abby skelton: abbyaskelton
Cate: cateadamss
Matrex Kilgore: matrexk
Mar: maritza.mcneal
autumn rose: autumn.haney
Mariano Delpree: marianodelpree1
Anna Groch Jiampietro: aniagrochj
Colin Felan: colin_felan
Carly Barnett: carly.barnett
caroline baird: carolinebairdd
Eduardo Orozco: eduardoo.ig
Thomas Parsons III: yessirtpain
NICOLE KULA: nicolekulaa
: llaurenpattillo
Marcella Hilmi: co__cella
Nick Gargione: nickgargione
Cameron Parham: cameron.parham
Debbie Hedley Jackson: nufcfan1974
kate: kat3br0wn
laura: laurasalazarrrr
Harrison Murphy: harrison_s.l._murphy
Gabriella: gabbycarvelli
Tori Ackert: tori.ackert
Andrew .J (El Presidente): real_andrewjackson09
Le Journal d’une Pluviophile: ghazale.en
Suzeth Roman: suzeth_roman
Nicholas Enriquez: nicholasenriquez05
trin: trinity.ivy
Connor: csh_16
: phdexhausted
Monk: mikeypro14
Lauren Dunlap: lauren_islegit
Riley Smith: rileyy.s
sophie: sophieplumer
Jessica: jessica_jane_1976
Kenny Cruz: kenny._.cruzz
: thisisjust_an
Kai Robinson: kai_robinson11
: ella_porter31
kara paige <33: kkaramorriss
Nathan Thomas Eck: nthomas_eck
Caden Dragoo: cgd99
Autumn Beck Blackledge: autumnblackledge
Manoo S.: manoosirivelu
Zander: remy_uwu
JZ: jade.zoller
Evan Woodward: evan.woodward
Oh Word ?: brandoncortez.ig
Cyn: c.y.n.fitness
Kaeden: kaeden_th
Vedika: vedikaxsinha
averie varnado: averievarnado
Julian C.: juliancastillo__
Grumpy14: grumpy1416
adonis: theoreticaladonis
Christy Satterfield Robinson: christyrobinson0227
Morgan Welch: morgan__welch
bebe irwin: bebeirwin
Alejandro Garcia, REALTOR®: acho.g
jazmin bernal: jazminbernalll
: alex_rodriguez27
Aadi: adyathanaadi
Abbi Jeffers: omnioomega
Jahggar: jahggar
aiden: aiden.tijerina
Manuel Martines: manuel99__
David Gonima: david.gonima
ammad: ammad.hasann
: _s.i.e.rra
Erik: fern3225
Alex: __alexsaenz__
danielle rae: daanielleraee
Shoaib Kabani: shawnkabani
mads: madison.demauro
gabby :): gabby.d82
T. Wessley: alphasource2
~Grace~: grace_scarborough_
Jane Henry: jane_henry_176
FOX_VULCAN: abhishekyadav.2003
yanelli natali: yanelli.natalii
Roman Orsini: roman.o
Jadyn Hernandez: jadynhernandez54
Jay de la Cruz: jayinstahubbysatx
micah barker: micahbarker_
Mike Magallon: mmagallon26
Txcheck: txcheck4
Waterloo: waterlooaustin
ariel.: ariel_1107
Audrey Mitchell: audreycmitchell
Bonnie Rodriguez: bonnierodriguez1
Julian: jujubeanbb
madi: madelynjordannn
lindsey bennett: llindseybennett
hailee nevaeh <3: haileenevaehh
: nahlabeltran
Lexi Robinson: alexissrobinson
Ariana Rodríguez: ariana.rodriguz24
Jenny Allenbaugh Hendricks: jennyhends
Daisy: random_memes_1_4
Ava Ceraudo: ava_ceraudo
braeden: braedentidmore
sergio: kronos14362
Sydnie Karel: syd_karel
Lilia_Oberlin: selena.bartholowmew
DylBob: dylbobmart
GURAH: gurahsa
Maya Walker: mayajwalker
Gil: swimcoachgil
Alan Barrera: alancbarrera
carla: dontcallmecarlitapls
ut ‘26: aidanscottchristensen
Jose Natera: josealenatera
Sam Warden: samwardenn
: parker_massey10
Jaylin George: jaylinchangeo
: jacobbarron_23
Paulina 2003: karencolorado03
.: ooooojdjsjd
Angelica Salinas: ansalinas1725
A'Jahnay Nayy: nayy_babyyy_
Cameron Loyet: camloyet
Maloree Kuhn: maloreekuhn16_
Tiffany Alameda: tiffany.alameda
Jake: jakegirarddd
Jermafan Goonberry II: goonberry_family_tree
College At The Austin Stone: college_austinstone
: tyson_j0
: al0nz0g
Marquis Flores: back_fail_spamm
Texas Phi Kappa Sigma: texas_skulls
Araceli Ramirez: a_ramirez_araceli
Marcela Ruiz: marcelaruizal
giørgette ruiz: giorgy.ruiz
ELISE WEBB: elisewebb
~lila katherine leach~: lilaleachh
Samantha Burg: samantha.burg
Steven Mascolo: steven.mascolo
Alyssa Osorio: alyssa.anahii
William: elfamosowill
Taylor Walker: taylorwalkeer
austinfoodxvibes: austinfoodxvibes
Alejandro Mendez: alejndro.mendz
bradyn riley: bray.yates
Mason Ibrahim: masondibrahim
hayden bennett: haydennbennett
mack harris: mackharris802
caden baker: caden.estelle
beaded by rachael: beadedbyrachael
Caleob Houston: kaydizzy._
Matthew Porchas: matthewporchas
Chase Smyth: chasesmyth
Cami: camilegarcia247
amanda: amandabluegarza
Ryan stocam: ryanstocam9898
Heather Goodman Finley: lipstx4evr
christian.tiera: christian.tiera
Arianna D. Alaniz: _ariannaalanizz
Gomezsmart: gomez__smart
baseballislife03: baseballislife016_
The Callaway House Austin: callawayatx
: mary_johnson_xx
The Castilian - Austin, TX: castilianhall
Phillip E. McAllister: koolkountry
: _dom.pvt._29
Juliet Janét: atx.scout.juliet
Kendrick's Customs: kendrickscustoms
Willy Limy: willylimy
Henry: henrybturner
Longhorn Hellraisers: longhornhellraisers
essay guru: writer_lauryn
BlingBottles: blingbottles.college
nidhal.nick: nidhal.zia
michael amelaus: michaelamelaus
Conner Kuykendall: conner_kuykendall
Abdelrahman Gohary: abdelrahmanelgoharii
Chrissy: sivad4plus1
arimizell: arimizell
San Diego State ‘26: sandiegostate_2026
Farah: artxfarah_
Ojo Michael: ojomichael3273
: woken_soul10
Snowflakes: snowflakes_onthelose
utbeauties40@yahoo.com: utbeauties
: raham.0044
Benjamin Bilski: the_bentrepreneur_3
: sun_goddess_ari
