Followers:
 
hailey!!: hailey.mp4
logan :): loganvitagliano
sof: sofiefinch
The Mark Austin: themark_atx
sanjani: sanjaniseetepalli
Colin Covington: ccov_04
claire cahoon: claireecahoon
Shivani Jariwala: shivani.jariwala_
Stephanie Calderon: stephaniecalderonnn
zoe lemaire-jones: zoej217
Karla Boussart: karla_boussart1
camille gm: camille_agm
ELISE MORAN: eliseemoran
kate mclane: mclane.jpeg
Hannah: legithannahshyann
Mary: maryccreel
Alexa: alexa.ocallaghan
anjali :): anjalicherukuri
: phoebe.cosgrove
caroline: sugarspiceandbadadvice
shreyas: shreyasc714
Kerri: kerri.mariaa
summer :): summer.fugere
carly gaudin: carlygaudin
Alysa Madriz: alysamadriz
Amrutha Ayyappan: amysunstar04
Rosy Esquenazi: rosyesquenazi
Waamene Yowika: imsognarly
alyssa lane: alyssalane._
Sudiksha Gudipati: snereksha
sydney: sydneydlai
Madison Baer: madisonbaer72
kate winston: kate.winstonn
kt: katiesiddonss
myles: myles_awayyy1
Carlos Hinojosa: _carlos_hin0
Donna Waitkus: donnawaitkus
NINA RALSKY: ninaralsky
arianne tsioutsias: ariannetsioutsias
yubin <3: yubinkkim
Lucasbakken: lucas_bakken12
Odette Saenz: sarazensara
Misty Pennock: mistyinaustin
jenna struck: jenna.struck
Kavin Sampath: kavin.sampath
Alexis Hunt: alexis_hunt_
Elizabeth: elizabethxgerber
chenyi: chen.yi.wang
Tori: victoria.rodd
Anna: annagreen04
Albert Vierra: albert_vierra
gaby zurita: gaby.zuritaa
Cate Casey: catecasey_
Charlotte Eades: char.eades
Mary Nelle: marynelle_cravens
kenady: kenady_cooley
Alejandro Lopez: _alejandrolopez4
hailey hirsch: haileyhirschh
kennedy renae: kennedyrenae_
Hudson: gouldhudson
Emily Wilkinson: _emilywilkinson_
Paige: paigemeridian
Samantha L.: sam_leidel
Dani Rose: danimirin11
Austin Gardner: austinthescholar
Lucy Simon: lucysimon_4
maekayla effinger: maekaylaeffinger
natalie rozmus: natalie.cassidyy
Sree: sreeduggirala
crystal zimmermann: crystalzimmermann_
Tegan Powers: teganpowerss
Joseph Franklin: josephjo.frank
•sophia black•: sophiablackk_
Olivia Gerhart: livibeannn
: jadejessica014
Christoph: christophxklein
diya bhatia: diyabhatia27
tisha: t1shashrestha
Audrey Braugh: eaudreyb
Isabela Salazar: salazar.isabela03
Emma Nagle: _emmanagle
vivek: vivek_m.7
Byrdi Beggs: byrdi_maye
hailey smith: hhaileyysmith
Gabriel: gxbe.ee
Hannah Koepp: h_l_koepp
Jordan Norris: jordannorriss
: kev_barcenass
lily: lily.corby
helaina gilmer: helaina_gilmer
anusha singhal: anushasinghal_
Abdullah Sharif: abdullahsharif_
catherine: tragically.y
Sophia Barnes: sophiaaabarnes
Isabella: isabella.y.wade
chloe romero: chlo.romero
Ali Zaidi: alizaidi_04
lu bierrenbach: luisabierrenbach
Sarri: sarrionna
Likhita Velmurugan: likhita_v
Emily Estes: emilyestes22
Breela: breela_m
pro writer: essay_guru12
Melanie Charron: mel_charron4
KP: kayla_prevost
Annika Hesse: annikathesse
Keira Rusinko: keirarusinko
emma cate: emmacategall
Jordan McAlister: j.mac41
R Y L E E: ryry.yryr
amy bae: amyhbae
Jamie Ordonez: haiiimeeee
sarina: sarinakunwor
arielle: a.ria.lle
Leah: leahebaud
Andrew Daitch: andrewdaitch_
Patrice: patricehayes_
Madelyn Leonard: madelyn_leonard
Sai Narayan: sai.narayan17
kat: kathryn.thomasonn
Aadhav JaiMurugesh: astroaadhav2004
Eric Medina: yolerfromteheavens14
Jadah Garza: jadah.garza
jerry: jerleecab
Jewell cooper: jewell.c0oper
Alex Tu: alextu27
Luke Schweizer: schweizerluke
Kishlay Singh: kishthelay
Jonathan Moon: jj_moon1414
raely fitch :): raely.f
Nate Martin: nate.martin6
: rahulabraham03
Storage Scholars: storagescholarsut
mahek dodani: mahek.dodanii
Ryan Couron: trexcouron
anil cacodcar: anilsc5
kyla mchale: kyla_mchale
marissa: mariissa.ann
gracie leal: gracie.leal
Melissa: melissajhaveri
Aziza Norova: micnorova
Nina: nina.velacheri
Christina Diaz Estrada: christina_825
aza.: azaaniah
madisen lieberman :): madisenkate04
Lizzie Coyle: lzcoyle
frances di carpegna: francesdicarpegna
halle schenk: halleschenk
Ben Wells: benwells15
Soham Choulwar: call_me_soham_7777
: kynadi.jones
Adithi Rao: adithirao_
Aksh Tyagi: akshtyagi04
Anthony Okeke: its.only.okk
Sofia Frey: sofiafreytx
yasemin dündar: yasemindundar
Ty: ty_wilson29
Jenny Chung Lew: jennychunglew
Ricky Rodriguez: rick.mo.03
Irene: irenehassann
mina gollogly: minagollogly
soumika: smka134340
Ellie Hague: eahague99
Amie Nguyen: amiednguyen
Ryland Marshall: rylandm23
Nerwen Cao: caoyuqing130
william_stocam: william_stocam25
Shridha :): shridharajeswar
Steven: ratoftexas
ava: avadawson2
Isabella Alvidres: isabella.alvidres
Daniel Meglino: daniel_hur_meglino
isabel redwine: isabel.redwine
olivia: olivia.cagle
nishi: nishichatram
Gerardo Gomez Garcia: gerard0gg
kourtney miller: kourtneyymiller
Sean Macias: seanemacias
aakruti: aakrutidesai_
mia: miafupetersen
kayla: kayla.sorge
Lauren Misencik: laurenmisencik
Syd Moss: moss.syd
Heath Harris: heath.harrisss
Daniela: _daniela_2624_
: _._jinna_._
Shree Allada: shree.allada
Martin Mulinix: martin_mulinix
Sabhari Senthil: sabhari18
tatom: tatom.hoffmann
Yasmin Jenna Jackson: yasmin_jenna_jackson
dani durham: danidurham_
jas: jasmineeweng
Sarah Root: sarahroot_
makenzie: makenzie.long17
Eleanor: eleanoranderson__
: akshita__
Olivia LD: olivia.j.ld
sophi maynard: sophia.maynard
DHD: dhdimichele
Rebecca Starling Klatt: uthemomrock
Varun Vedala: varun_vedala
Big dee: 4starr_dee
apoorva :)): apoorvagobburu
MADI: madibbourne
Brock Williams: brockthebeast03
Ashwin: as.hwinn
Victoria Mentzer: victoria.mentzer
KAELEY ROBBS: kaeleyrobbs
siri: _sirib
varshini: varshini.chinthareddy
anvith: anvith_reddy666
Josh Elizondo: thatcat724
Jonathan Xi: caiyujonathanxi
[Ireland Blouin]: ireland_j.m
trish: trishad19
Kaley McKinney: kaleybmckinney
devika: devikasunil1
ave;): averyy.raynee
mads: maddiepopp_
amber liu: ambersongliu
bella: bellsdom
: reganwalkerr
Ali Patterson: alissapatterson_
justice elise: _.justice.elise._
Sarah Shelton: sbshelton04
Morgan Davies: morgann.davies
Lauren Jeanes: lajeanes04
Katelyn Puello: katelyn.mia
Sofia B.: sofia.bhargava
sahithi: sahithi_alla
shamiha: promy.y
Robbie: robbie.valcarcel
Jungmin Kang: itsjungmin
ameya: ameyayelne
: pranav.bhu
Alex VonHaven: 8_alex_v_8
maya orenstein: mayaorenstein
luna: lunareichert_
Vineet Puranik: vineet_puranik
Wade Arntzen: wadearntzen
Sammy: _sammy_sway_
Brady Schlosser: bradythedude
annabelle: annabellegibbs_
jeremiah solfronk: jeremiah_solfronk
Katie Hardesty: katie_harde
Hailey Hunter: haileyhunter1104
Patrick Gallagher: patrickg_keeper
Elise Morrissey-Rocha: _elise_autumn_
Anna:): adobre25
sabrina merkle: sabrina.merkle
Nikolas Parker: parker.nikolas
soni: sonii.shukla
Genesis: genesis.r.p
lex: lexi.parks
Alexis Headrick: aplexx990
Colin Angel: colinjangel
Olivia Swonke: olzswonke
Terri deGarbolewski: terridegarb
Cbass: baby_jee_18_
miranda: mirrandahidalgo
sage rose: sagefuhrman
Sanjay Sivakumar: s.sanjay011
Edward Schock: edward_schock
Pich Chea: picherette
Naysa Leach: naysaleach
Annabella :): annabella.saccaro
Sushan Chaudhary: sushan_chaudhary1
Abhiram Naredla: 33abhiram
Emma Milton: emma_l_m_
faith: faithbouchelle
mike: _michaelsuarez22
Ana: anapaulakendrick
free the nip activist: haileys.hail.storm
allie!!: allie.kam
Christina Balboa: christinabalboa_
Vivek Patel: vivekpat.el
Linh Dam: linhlinhsumiii
Diego: diego.45c
jahnelle: jahnellemata
: arpan.shresthadg
dev: dev.21_04
Maxwell Diamond: maxwell_diamond21
Kashish Bastola: kashishbastola
reagan: reagannnbrownnn
sophia: sophiashwaiko
zare: zarekokic
Richie Raclaw: rraclaw20
Erin Brogan: erinbb42
Sara Hickman Ridder: sararidder
Heywood Davis: they_envey_me_the_most
Sonal Kothari Shah: sonalkotharishah
julia: julia_thomas04
mihika: mihikapatankar
Ryan Karkowsky: ryankarkowsky
Pranav Kopparthy: prkopparthy
Gracie Covil: gracvilin
Rodney Nguyen: sofboirod
Bailey Evertson: bailey_reese22
kate white: kategwhite_
hannah farris: hannah_farris_
alexa: alexanuncio
Ryan Qu: r.quuuu
mairany: mairrany
: simmy.ghosh
Will Anderson: andersonn.williamm
sophie kolbe: sophiekolbee
hailey: haileyywilliams_
Andrew Tang: an_drewtang04
Rahul Chalamala: rchalamala
jayde hamilton: jaydehamilton1
Aditya Sangana (Airbender): adi.s.7
julia quigley: juliaquigleyy
Kevin Ortiz: kevin.orrtiz
Maddie Wueste: maddiewueste
Robert Behmer: akabob7
Lauren Darzy: laurendarzy
isabella !: isabellaa.34
~Carmen~: carmen.bautista28
Texas Swifties: texas.sas
sim: simran.shah15
catherine: _catherinebui_
sahana: sahanakaushik
Audrey Paidle: love_dance_audrey
Jocelyn Kovach: jocelyn.kovach
Dorina Balogh: dorina__balogh
LittlePancakes: thelittlepancakes
Caroline: carolinee.haros
nadia: nadia.toh
Daniela Schmeichler: danielaschmeichler
lauren parker <3: lauren.0.parker
mikey: mikeyje04
Bryce Strongin: brycestrongin
Clarissa Carrizo: clarissa_carrizo
ellie michelle: elliemgarcia
Mayy Alsawfta: mayyalsawfta7503
a v e r y f i n k e: averynfinke
Rimsha: riimshas
: uhh.kelly
shreya: shreya.jagan
Dhdjsksggsiagsj: sgskshsgsms
Cristina Campbell: cristina8399
Galit Beraja: galit.beraja
allison: allisonjyang
Lorenzo Lavigne: lorenzo_lavigne17
Ethan Fang: efang_12
: drewcohen11
A.P.: allisonpow3ll
Justin C.: jstn_n_cln
anna: _agrove101_
Sarah Lee: sarah_lee0414
Tapasya: tapasya1807
Maddie Mandel: maddieemandel
Stephanie Lytle: stelyt
Sophia Lagen: sophia.amaliaa
loran johansen: loranjohan13
harper: harper.cunningham
Riley Schultz: therileyschultz
Siena Theivagt: sienatheivagt
OLIVIA JACOBSON: livvvjacobson
Nayeli: nayeli.isabel24
janine medrano: janine_622
K I Y O N N A: kiyonnakapoor
: _ishaaa_d_
JANIE: j.bickerton
M&M: marymichael.g
I S A B E L L A: isabellababba
av: avalon.mitchell
Khun Cho Thar Lwin: khunchotharlwin
Pranit: pranit7810456
Aleena Joseph: aleenacjoseph
laura haas: laurahaas12
Clayton Bouwhuis: claybouw
Nehir Aran: nehir_aran
Andrea Aragon: andreaa.arag0n
Charlie Satenberg: charliesatenberg
ava bathurst: ava.bat
Allison Estefania Rodrigues: allisonrodrigues5
Halimot B: halimot_b
Alexandru Georgescu: alexutag10
hannah: hannah.fialho
isa almeida: isabellagomesa
kyrielle: kyrielle_1
ania davila: aniadavila
Vik Gokli: vikgokliii
alexa summers: alexasummers_
Shrey Kapoor: 777shrey
Steph<3: stephily2
A b b y F a i n: abbyfaingarrett
ashley guajardo: ashley.gdo
Shalini Parepally: shaliniparepally9
Lily Barrow: lily.barrow
Vaishu: vaishumarreddy
kylie prince: kylieprincee
Hannah Moore: moore.hannah_
Bella Arndt: bel__4
krissa:): krissajhaveri_
arushi sharma: arushi.sharmaaa
d: diana.valdiviia
Mikayla M.: itz.lyricxl
: jordynfeenberg
Ericka Dusek: erickadusek
Ashwin Kodibagkar: ashwinkodib
Ruby Manley: rubymanleyy
harrison: harrisonhensleyy
Ryaan: ryaan.hussain
daniel: __dani.t__
ankitha: ankitha_194
tanay bawa: tanaybawa
S ¥ D: syd.noelle
Coco: cocoholcomb
kendall karoline :): __kdoll__
Hudson: hudson.gutie
Holli Ahiers: holliroseahiers
Madhu sharma: madhuhhvsharma
Tina Pham: tinapham1211
anjali: anjalibaratham
kind of kind: kindofkind.tx
UT Austin CAP Students 2026: utcap2026
Ryan Salaman: ryansalaman
viggy :): vignesh_vrs
Payton Thurman: payton__thurman
: jacksabo_
Garrett Smith: garrettsmith031
Walker Francis: walker_francis
veronica martin: stylebyveronicam
DANIELLE PETERS: petersdaniellee
ELENA SOFIA: elena.c_
Sriya: sriya.gonuguntla
Mingy: mingyperez
Tommy Bannon: thelifeoftommy_21
Sasha Jones: _sasha_audrey_
maja: veracmaj
Jonathan Li: jonathan_li_0
Richie O'Brien: richie.ob
aashika: aash.ika
Riya Patel: rriyapatel13
Milkman: bordenwyatt
Roopa: roopsy.daisy
Logan Wright: logan_lt40
aarushi: aarushichitagi
EMMA GRACE ALVEY: emmalvey
Liv: livschlossman
Anagha Natarajan: anagha.natarajan
emily achtermann: emilyachtermann
Julia Cherkesov: julia.ch164
Gini Dyer: ginigdyer
Kenna Tolman: kennatolman
meera: meera_meera_on_da_wall
Jackson DeBorde: jackson.deborde
Ava Wiederaenders: avawiedey
Evan Chambers: echambers_
Jaqueline Del Angel: jackie.da
Harrison B: harrison_b4
Anika Mittal: mittal_anika
julia schwaeber: juliaschwaeber
Steven Nguyen: stevenqtnguyen
catelyn: caty.the.unicorn
hannah: hannahtooleyyy
Kiara Souza: kiarasouzaaaa
Aldo Frausto: aldo703_
: irgennnnn
freddy: freddyguo_
kirthana: kirthananore
Hailey Garza: haileygmarie
Ian: iannn_salinasss
Regan Perrin: reganperrin
libbie brown: _libbiegrace
ava holt: avareneeholt
Kate Kittleson: kate.kittleson
TJ: itstjkohli
Aditya Rai: ar005623
H e l e n a: helena.de.moraes
Paula Andrea: paulafaccini
nick n: n.ng04
vidhi: vidhisapru
Lauren Greenbaum Laitman: lululaitman
Kelly Riley Callaway: kayceecall
Netra: netra_krishnan
Sophia Fente-Damers: sophia.fd
Will Eagle: willheagle
Bonnie Lau: bonnielauuu
Emma: emma.nicole.m
sri: sri.chandrasekaran
Eva Childs: evachilds
alex nabors: alexnabors
Larson Crank: thelarsoncrank
Lagunas, Bethany: betania.1
Stephanie Jumper: stephstephj123
Tate Elfarr: tateelfarr
Steph: stephaniemmurrayy
Aditya Sharma: aditya_sharma2622
Ryan Sobol: ryan_sobol
benet-elizabeth: benetelizabeth_
Liam: liamstemetzki13
Bennett Broaddus: bennett.broaddus
ava thomas: avaa.thomas
magali: magali.larraga
caroline: caroline_maee
isabella vazquez: _isabelllaaaaa_
Jack Staton: jack_stat0n03
Sam Lu: presidentsamlu
claire: claireschulter
Scott Khoury: scottkhoury
mim: miriamcrouse
Prisha: prishamultani
: sophrasberry
Evan Lai: greendog2121
kennedy :): kennedy.a.baker
Emily Nguyen: emilynguyen522
emma houston: eemma.leighh
Praghya: praghyaraja
nila: nila.shankar
Carson Domey: cjdomey
nat: natalieanspachh
luke: luke.blausen
Aidan Leonard: a1danleonard
: dana._lee
E L L A: ellaaprasad
andrea: aandreaortegaa
Leslie Saenz: lesliee.ees
LEXI: alexisdmalone
ella grace: ellagracewhite_
mayah: mayahe12_
Jordan Mastriano: jordanmastriano
becca:): beccarincon
William Braffman: wbraffman
R I A: ria.narayanan
Isabela Salazar: isabelasalazar061003
: clarissa.terrones
yanely: yanelymolina03
Jonah Maxwell: jonah_maxwell
danika: danika.gonzales
Jose Moreno: eljoseamoreno
o l i v i a :): olivia.pettis
ELIJAH WILLIAMS: llijah__
Neil Goyal: neilgo12
: medhabhonsle
Isabella: isabella.sruiz
Hampton Pillsbury: h_pillsbury
brendan: brendanreynoldss
shivani: shiivaniikumar
eesha: eesha_nayak
grace!!!: grace.stern
brielle: briellelizabeth147
Miles Royer: miles_royeet2003
Mateen Lindsay: mateen.lindsay
bella !!: iisabellagonzo
: franiafloress
Pari Latawa: parilatawa
Purvesh Joshi: purvesh_joshi
Natalie Druffner: nataliedruffner
hannah: hannahtthai
cassie: caasssiieeee
mads: madisladecek
apurva :): apurva.mamidenna
Gianna Zagone: gianna_zagone
: bryanscalixto
Andrew Wilson: andrew.wilson14
Paige: paigepace16
gracie lynk: gracie.lynk
rebecca: rebecca_oladejo
ari patel: _aripatel
Caleb Fleischmann: calebfleischmann
mady kahn: madykahn
o d: livvdavvv
Ellen: uuyu092
MIA: miageist04
Seamus Carragher: seamus_carragher
sophia campbell: sophia.renn
emilia !: _emiliafong_
ryssa:): aryssa.camenisch
Brooklyn Gibson: brooklyn.m.g
jC: bisou.j
Chloe Robinson: chloemrobinson
Mary Courtney Finn: marycourtneyfinn
Lilly Bacot: lillybacot223
shreya: shreya.trivedii
Naveed Sadarulanam: navs4601
Coralynn Cole: cora_god_and_photography
Cam W.: cam.books4124
Emma McNatt: emma.graceful
Miloni: miilonipatel
Lily Davis :): lily.davis24
Nathan Zachariah: nathan.zachariah
ARIEL DOSS: arielmargaux
sara kate !!: ssarakatee
jayne: jaynepartida
maya: mayapai_
Daniel Garcia: gibj
Abbie Valdez: valdez.abbie
lauren lindemann: laurenlindemann_
jules :): julesmurillo4
Maahir: maa_h22
: k.bhakta04
Yoshee Jain: craze4yj
soph: sophiajohn._
Ava :): avaaidala
ava: avajanakk
Lauren Rose: lauren.rose3
: l3naaaaaaa
hope vanderburg: hope.vanderburg
Rachel Norris: auburn_rachel
Alec McGhie: alec_mcghie
parker !: chordsofyellow
Sourik Sannigrahi: sour.ik
had: hadley.olsen
Diana Barba: _diana.barba_
Brooke Rogers: brookerogers08
Sanaa: sanaaalewisss
nicole: nikki_hilscher
lex: alexa_varela
Aaron Phan: aa.ph4n
Linz: lindsey.hughes
Jason_sharer: jason_sharer
• virginia nussbaumer •: virginia_nuss
Sungwon Mike Chang: swchang22
MEREDITH MILLS: meredith_mills
thomas chun :): thomaschun_
Gracilyn Hardy: _gracilynhardy
taylor lin: t.tayyylor
Evelyn Nguyen: evelyn._.nguyen
ANNA: anna.pasc
mia: mialazzari
Navya Agrawal: navyaagrawal025
Savannah Tipton: tipton_savannah
Elena Khanlarbeik: elena.khanlarbeik
Michelle Ogu: officially.michelle
Reyna Shah: reynashah_
Sathvik Boreda: sathvik_b1
Timmy Pettus: timpettus_9
sophie cain: sophieecain
evan: ev.nx
giovanna <3: giovannamcleann
Jenna: jennaabulughod
Lilly: lillyredwine
sydney lamphier: sydlamphier
Whitney Reid: whitneyreid_
Ainsley: ainsley_nelli
monii: monica.monii_
Katelyn Nguyen: katelyn___nguyen
Tatum Eades: tatumeades
Ayush Patel: ayushpatel419
Natalia: nataliaorteega
sophia labeau: sophia.labeau
leanne!!: leanneji
SALLY CASTER: salcastrrr
Stephaniehultman: steffiebhultman
alease!: alease.lindner
rabah: rabahanwar
Rahul Kumar: rahul_kumar284
Grant Brewer: gm.brewer
arv: arvinquazi
Aubrey Lopez: _hey_aubrey
Jillian H: jillianh_04
leah: leahc.barragan
Katie Cohan: katie_cohan
ant (taylors version): hotter.than.ur.mum
Aliyah Banerjee: aliyah_banerjee
madeline hoang: madelinemaih
isabella martinez: isabella.martinez22
Jordan Emerald: jordan_emerald
Sadie Hill: sadie_ehill
Katlyn Huynh: katlynhuynhh
Whitney Reinkoester: whitneyreinkoester
Austin: austin_friedman13
Donya: dawnafshang
Taylor Eckel: taylor_eckel
Leila Rabah: leila.rabah
: _ryan.hopkins_
leslie: leslie.esss
Lance Zhang: lancezhang04
Mary Louise Buchek: malou_buchek
: ximena1809ps
trisha bala: trishabala_
Summer Hamilton: essbreezybaby
annika lærum: annikalaerum
Mina Jeong: _minajeong
Monisha: mnmonisha24
sarai <3: sarai.915
ariel: arielbarley
: caseymarvin_
ricky: ricardoo.ortiz
Taylor Gardner: taylorgardnr
kathleen: kathleennnguyen
Vanessa Nguyen: vanessaanguyen
Sophia Nguyen: lifeofsophianguyen
Henry Roth: henryroth10
Reagan Schluter: reagan.schluter
Frensley Smith: frensley_smith
Matthew Hiebert: matthew98hiebert
Shayna Meek: _shaynameek_
mason: mdblalock
Ben Hamel: benhamel1
Andie San Luis: andie_sann
: yaasmmeeen
amanda: amandafoy_
kenna dahlberg: kennadahlberg
Matthew Shapiro: matthewshapiro_
Belinda Marin Boling: belindaboling
Mala Gupta: malagraceg
†: christinejacobb
Ethan Paik: ethan.paik
selah: selahnorton
Lauren: _laurenethomas
Caleb Solorzano: caleb_solorzano
Sofia Ixcotoyac: sofia_ixcotoyac
Gavin James: radskater382
Adi Behre: adibehre
: madisonpoopoo
Akshay Pradeep: akshaypradeep2004
Mary Katherine: mkpalmer_
Lili Tomko: lilitomko
bella!: isabellaa.thomas
Chloe Miller: cchloemillerr
danielle: danil_01707
Manan Khandelwal: manan_k04
Brooke Williams: brooke.a.williams
Sophia Gallegos: sophie_108_
Jordan Yagaloff: jordanyagaloff
ale leal: alejandraaleall
koa fujimoto: koafujimoto
shrika ;)): shrikaaa
Ski: rahman._md_
shree: shreeganeshh
Trisha C: trriiissshha
Peter zejmis: peterzejmis
Ben Kompare: ben.kontrast
Alana: alana.bowman2021
: adamrosemann
lauren: laurxnnicolx
gene: genephqm
Jules Larimer: juliana.larimer
ari b: arianabhimani
aidyn neiman: aidynneiman
: swlkrrr
Hasan: hxsanmurat
Raghav Punnam: raghav.p35
G I A: giaperel
Jacob Sedlacek: sedlacek.jacob
Rebecca Patino: patino_spamz
Georgia Ann: georgia.everetttt
A L E: ale.merodio
Yuji Yasuda: ptxyuji
Matthew Martinez: _mattmartinez
Daniel: d.aniel19_
Gen C: genincdu
Reese: reese_winn
Claire Traywick: clairetraywick
myranda duran <3: luv.randa
GRACIE: _graciekent
natalia orejas: natiorejas
WIJ: mikail.wijesekera
Hanif Lawal: hanif_lawal
: nastycasty_
Angela Tatsch: angela13_764
Divya S: divyash00kla
: carlyymccausland
holly keenan: holly.raico
Melanie Sandoval: melsand.oval
k r i s: kkristenharris
Laura: _laura_baker_
madelyn grace: madelyn_troy_
mel: melat_w
: stella.truong.13
Shrey Shah: shreydshah
Zeynep Ertuna: z.e.y.n.e.p_22
Genna Adelizzi: genna.adelizzi
zafra <3: zafra_haque
ava!: avabirch_
Krithik Vishwanath: krithikvishwanath
Barbara Sorensen Geer: barbarageer
hannah nixon: hhannahnixonn
lila: lila_orr
julia<3: juliaraghu
ISABELLE GREEN: isabelle.victoria7
Alejandro Banchs: alejandrobanchs
Farzan Shiju: blufiusmarqueetii
Kristal: kristalnicolee_
Gaby Williams: gabriela_williams_
caleb :,): cal.eb24
alex: alexx.goodwinn
ayden bell: aydenjbell
isa: isa_garzaa
Sofia White: sopapillaaaa.__
Katherine :)): katherine_nix
: levii.robinson
Ariel Hernandez: __ariel_h
: nickwalsh7
Ernesto Vargas: ernestovargas1803
KG!!!!!!: katherinegraceestess
Walker Thornton: walkerthornton_
Cami Morataya: camilamorataya_
Valerie: valll_770
dani: danielaipatino
Alex Bellucci: looch_3
Emily Grab: emilygrab18
Tiera Hall: 0tiera0
ariana ruiz :): arianaa.marieee
neha marneni: nehamarneni
Sofia Elisa Cabello: sofia_cabello3
mia!!!: miamckenziee
margarita ovalle: maggieovallee
mariana peña: marianapennaa
VIV: viviankbrooks
Sachi: sachi.kacker
Elaina Hamuy: elainahamuy
hans: hannarimel
: amandaharrelsonn
Aarshi: princessaarshi1271
vani: vani_shaah
Parker Davis: parkkky.joy
Andrew Rovit: arovit2
Victoria Lee: victoriatheleek
Jacqueline Barnett: jac_eyed_peas
Duncan: duncanrattray
Roberto Garza: rrobertogarza
Logesh Naidu: logesh_6363_
Kiara Ballay: kiara.ballay
Brianna Vick: briannaavick
Charan Vengatesh: always.charan
evan: evan.hudgins
Abby: abigailrodionov
Jacob Lee: jaccob_._
emma: emmayates__
Allie Singer: allieesinger
ash: ashleymoyerr
Bingbing Wang: bingbing.wang.5070
Anna Moore: anna_e_moore
uly: ulyhateseveryone
monse: mooonsay
Adnan Dollar: dollar_in_the_house
: user436888
N: ninapappas_
Jace Petrovich: jace.petrovich
Nick Ramirez: n1xk.ram1r3z16
Natalia Ortega: natalia2ortega
Bobby Ziff: bobbyziff26
Cyrus Bronson: cyrus_bronson
Natalie Lawless: natalie.lawless
reynuh: reynadews
Trisha: _trishacao
brooklyn: brook1ynd
pri: bittersweet_pri
Olivia Baran: _oliviabaran
Ross Wilkins: rosswilkins1
Jonathan Michael Teubal R.: jonathanteubal
vivian montoya: vivianmmontoya
nicole dave: nicoledave_
Sophia Callahan: _sophiacallahan
A L E X: alexcussimanio
Mia Wurster: miawurster
hana :): hana.sophia_
Lily Kent: lily._.kent19
Lex: alexa_smigel
lauren :): lauren_.simpson
rhea :): rheanna.patel
shalissa floors: spleshysplesh
Molly Garvin: mollygarv
utaustin.uex: utaustin.uex
John Bruton: john._.bruton
Kristine <3: krissycaridad
Kylie Finkelstein: kfinkelstein
Michael Hardie: mhardie12
Clarissa Flores: clarissamflores
Luke Reed: luke_reed_44
Zona Johnson: zona.johnson
: taylorrhoadess
___: drakeandjoshfan303
dani: daniellalf06
valerie smith: valeriee.smithh
Seth Hendricks: sethbhendricks
: liam.earthman
Anna Claire Frolichstein: annaclaire.f
Tanya K: tanyaaaaa.k
AVERY: averyschwartzzz
sammy: sammy.weinn
Saikat Chakraborty: saikat_chakraborty_iitb
Brooke Ubieta: brookeu04
Konghwan Shin: kh_s_ins
: blairsayers
Evan Craig: craigohaslosthiseggos
Addie Kimberlin: addie_caroline22
Payal Pandya Gokli: travelqueen101_
tessa mccullough: tessa.mccullough
Drift4life16: drift4life16
juliana hager: julianahager
hadley adams: hadleygadams
Reagan Smith: reagan.smith14
Nirek Brahmbhatt: nirek.b
Samuel Brack: samuelbrack_
Hallie: hallie_shepherd
Zach Boehly: zboe21
Kathryn Sullivan: kathryn_sullivan_
Isabella Reyes: bella.i.reyes
Matthew Olivera: _matt.oli
Batul Hasan: batulhasan
anna montgomery: montgomery.anna
revanth: revanth.mallala
caitlyn: caitlynarnold_
Stephanie Schmadeke: snealslp
Mar: maritza.mcneal
Haylee Bush: haylee_bush_
Samantha White: samantha.janelle
Paige_Dearborn: paige_dearborn
Leslie Wells: llacewells
N O A: noamoore
Aniyah Sealy: _.aniyah_
JAIDEN KEY: jaidenkey
Will Pechersky: willpechersky
Cakelicious: cakelicious04
Cassandra Maria: cassie.1012
Ethan Rubenstein: ethan.rubenstein
sam: samantha.hailey18
Amber Castro: amber.castrooo
ava :): avanguyen__
mimi <3: milicakonatar
danny ou: dannysrebellion
kaitlin bernal: kaitbernal
Parker Bondy: parkerbondy
Brianna Mata: briannaamata_
Amy Smith Pulliam: amyepulliam
teresa nieto: _teresanieto
Ansh: _anshpatel
nat: natalielongacre
Riley: rileytendler
Caleb Eby: caleb_eby44
daniela: danicontrerasojeda
paula: paula.noriegaa
Suzanne Mills Eades: suz.eades
Kevin: kevinscontreras
Will Stone: w_stone1
natalie rutherford: natalie.e.rutherford
Burrows, Josh: joshburrrows
Sriya Dommaraju: sr.i.ya
harsha: harshakosuri_
Maddie Savasky: maddiesavasky
Patrick Haynes: patr1ck.haynes
greg just: gjust3136
Caden Christian: caden_christian
: jaretzycavazos
abby: abby_hecker
surina: surina.19
Julie Marie: mikeandjulied
julissa: julliisssaa
sanya_lalani: sanya_lalani
hannah smith: hannahsmith_324
Sydnie Simon: sydnie.simon
Rea ;): reaganwhitehouse
Brookelyn Mayfield: brookelyn_dmay
Raven T: raven.t08
3mma: yar3mma
izzy b: izzybba
navneet: navneet.latawa
chris lopez: nuychris
JeniO77: jenifero77
Jorge Rivera: jorgeriveratx
Madeline Jordan: _madeline_joy
Dennis Sutton: dennisutton
: carter.ferris
Samantha Lee: samfaithlee
sofia delgado: sofiapdelgado
dani: danielamedin.a
sid: sidneymuntean
Samantha!: samantha.dahlin
Emily: emraecurry
tanisha padhi: tanisha_padhi
Sydney Jennings: sydneyelisej
kate christoff: katechristoff
Matthew Smith: mmatthewsmith
isabella: isabella.ravden
Serena Syed: serena.syed
Olivia Sperbeck: o_the_great_one422
Alex Tita: alextita_
Stella Kastanek: stellakastanek
Gavriela Deniz: _.gavriela15._
HTJ: h2jo3
hannah: _hannahcleveland
RyAnne Rovelo: ryannerovelo
Nick Bartlett: nickbartlett_22
kelly: kelly.matthewss
renee sarmiento: sarmientorenee10
Rhea: rhea.lazar
Alexis Carlisle: alexiscarlisle2022
Wilson Brizzi: wbrizzi17
Emeka Bielonwu: emeka.03
Natalia Vazquez: nataliacvazquezz
Tessa Howe: traehowe01
Mæ: mae.rizk
: r0bertmcgee
dain: da1n_03
Jessica Mikell: jessica.mikell
anushka: __anushkamaz__
Izzy: izzyg1955
ben: benjamin_tijerina
Bryce: _just.jeff_
: notanishab
Destin Drummond: dezdrummond
LAUREN!!: laurennllucas
Jennifer Mancha: jennifer_mancha1
Shaila Abdullah: shailaabdullah
meg: megan.benner
Malak Ahmed: malak_ahmed831
Lauren Markwardt: lauren42504
milla gideon: milla.gideon
Isabelle de Janon: isadejanon
Anjelina Ortiz: la_anjie
: jaimep.lv
Ansh: ansh_saxena52
jonathan shoe: jonathan.xu
Drew Nevitt: drew_nevitt_
John: greatbowlofsoup
kayla marie obst: kayla.marieobst
Lourdes Cabrera: louccabrera
zamira elizabeth: zamiraaae
Maddie Paige ™: madell._
ava williams: avaxnicole
Bella Gomez: isabellaegomez
Anish Doshi: anishdoshi04
Chantz Bell: takeachantz_
: ella.pollard
Julyssa Cantu: julyssa_cantu
Rachel: rachelxrdz
Sophia Rose LaCrosse: sophia.rose.lacrosse
: 0liviaperrin
Regina Salas: guwop.reginaa
Tom Grellner: tomgrellner
A-Y!!: _ahyoungkim
zev gordman: zevgordman
Shannon Mcbride-Strole: sstrole00
Mo-P: mo.noelleee
hailene!!: hailene.stitt
aj gamez <3: aj.gamezz
emma a: emma.abelkis
Lauren: lauren.lambrecht
bri <3: brianna.mcghee
kira berzack: kiraberzack
Ramon santos: sleepyramonsleep
Sam Battle: sam.battle.11
lila singer: lilaasinger
jada kabani: jadakabani
• sophie hill •: sophiehill__
Cole Sorosky: cole_tyler27
Colin Felan: colin_felan
Chandler Tompkins: chandler_tompkins
Jeanne de Moucheron: jeannedm_09
Abby Grosshandler: abbygrosshandler
Lindsay: lindsay.baronoskie
kooper kohut: kooperkohut
: pennygrams1966
mireya !!: mireyamedel
parker: pholland.14
Adyan Ahmed: adyann.ahmed
abby kremer: abby.kremer
: jackdmcmahan
mayan brittin: mayan.watson
Jess: jesssgallo
Berkley Matthews: berkleydmatthews
Claudia Babba: claudianinoska07
Kai Robinson: kai_robinson11
emma: emmagfarmer
diane: dianeduquee
sydney!!: sydneyaelvoet
Ethan: howat.ethan
donovan: waavydon
Morgan Marie Hernandez: morgan_m_hernandez
Raleigh Ward: raleigh.fw
sofia: sofia.alejandroo
lily: lilycoannn
brie: brie.schaff
Sadie: sadesandsmiles
olivia gonzalez: olivia8gonzalez
Phia Parent: phiaparent
Mary Margaret Stearns: stearnsmargaretmary
Samantha Dworaczyk: samantha_dworaczyk_
Stanton Smith: stanton_smith19
t a y l o r :): taylorrharris._
Santiago Garcia Rosales: santiago.da.un.pago
elizabeth pickett: elizabethpickettt
diana leija: diana_leija_
Reese Gutshall: reesegutshall
Beth Jaeger: bethjaegerr
ry!!!!: ryahmhill
McKenna Bayless: mckenna.bayless
katelyn perryman: katelyn.gp
Ainsley: ainsleyplesko
sawyer: stranger.sawyer
~ Allison ~: allisonpoda
Frannie Collins: franniecolllins
Finn Warren: finnwarren_
Jett: jettwinkler
ainsley burns: a1nsleyburns
mikey gavranovich: mikeygavr
Pradeepa: pradeepabalaji.4
emma: emmaaamoncur
Audrey Kirwin: audreykirwin
Tyler Leest: tylerleest524
Renee Chimock Grove: reneecg31
maria: avocadosarehealthy
Kabir Grover: kabirrgrover
: avabarrera
l i l l i e l o o s e: lillie.ann_
Jennifer Drake: jennifer.drake.716
Lydia Lloyd Mills: txlydia
Chayne: chayne_t
melanie: melaniebardaless
VOTE Perez | VOTE Vasquez: perezvasquez2022
Olivia Priest: livpriest_
daniela<3: _daniela.m.a_
Patty: pattytarica
Sommerlyn Babineau: sommerlyn.s.babineau
alex: alexandrageer__
Ava Picone: avapicone
Karen Itzel Cazares: karencazares14
:3: user89473634
Kayla Ngo: kaylaxngo
ally: allywinburne
Megan: meganknightt
Bryan Omodon: bryanomodon
Carly Barnett: carly.barnett
laura j: llaujimenezz
Isabella Forestieri: isabellaforestieri
Lisa Aldana: lmaldana20
: callieabrady
Karla <3: karlaaa_acosta
Bella Braun: bellabraunn
abby sharp: abby.sharpp
christianna m.: chr.xssy
laura: laurasalazarrrr
ava marsh: ava.marshh
Duggan Persyn: duggan.persyn13
anjali krishna: anjalikrish_
Sydney: syd.cannon17
Jake Elliott: jake_elliottt
: _anushkasaini
kallista:): kallistafogelsong
Gabo Solis: gabosolb
Juliana Sarria: juliana.sarria
Maddie: madeline.murphy
Aubrey ShyAnn Clayton: aubrey.shyann
Alison McDougall: aliemcdougall
ella burgess: ella.burgesss
Heather Doornbos Boler: doornbosboler
Luke: luke_hartfield
ANNA SCHLETT: annaschlett_
Ryan Spier: ryan_spier
linda maria salinas: lindamssalinas
: elliemwiygul
Braeden: choose2playpixelmon
Kimberly Stern Robertshaw: kimberlybobshaw
Trent Williams: trent.williams_
Sammie: samantha_vermeulen
Maloree Kuhn: maloreekuhn16_
connor rodriguez: cconnorrodriguez
Lynita Ayala Yarbrough: layarb
RACHAEL: rachaelthompsn
chong :): elaina.chong
roselyn <3: roselynnnn_c
Sumner Hill: sumner_hill
: k.redrick
Sean Avery: sean.averyyy
Grant Marshall: grantmarshall79
Will Aronson: will_aronson1
Sophia Sandoval: sophiasandovall
bianca cooper: bianca.coop
juliana jaasma: julianajaasma
katz: katiaa_bc
: cierraaharos
ISAIAH Morrison: spiderman20andeadpool20
aparna: aparna_kamath
Talon: talonblottin
: rh.eem
Andy: andres_garciajr
: jordynsskye
aashna mangal: aash.na_m
jayden: _jayden_.a
: elissse.bowman
dana yambao: dana.yambao
Anna Nowlin: annakellynow
Aramide Osague: aramideosague
Nicole Seiler: bedazzledbottlesnicole
katie schott: katie.schott
Morgan: morganmoseley_
Tina Rose: tina.r0se
Natalie Madeline: made_linees
mercer :): mercer_schulte
emma: emmaykal
skylar stepp: skylarstepp
bren <3: brenleefox
caroline cullen: cvroline
kyle nolan: kyle_n1
Dre: dre.rothb
Sophia: sophia.3100
Hailey Anderson: _.hailey__anderson._
Kenny Cruz: kenny._.cruzz
kenzie: __kenziewalker
: joeman.1
Robert Ebem: robertebem
Ng Minh: envyapple12
Mmc_htown: mmc_htown
Avery Zulick: averyzulick
• Diana Pedroza •: diianax
Trinity Brimelow: trinitybrimelow
Rama Vattikuti: ramatulasivattikuti
Ben Karam: ben_karam
sofia: soficadenaa
Maxwell: max.mun_
Abby Daehler: abbydaehler
taliyah harris: taliyah404
Dylan: dylan2flamand
Augie: augieaverbuch
LAUREN: laurengchou
Lauren McKay: lauren.mky
Carter Hull: carterwhull
Miles: miles.wray
Kristal: kristalguerrero04
Cate: cateadamss
Bella :): bellablohm
Andrea Quintanilla: andreaaeve
caroline: carolinecockrell_
Debbie Ballard: debbie.ballard
: marin.holley
Mary Claire Bach: maryclairedbach
Kiersten: kierstenfinleyy
Madison: mad_is_on_01
Raiyan Amin: stunnasaad
lauren engates: laurenengates
Freddie Steven Rebel: ofhisconfusion
ava werner: avawernerr
mads: madison.demauro
Ella Bryce: ellasnasdell
omar: om4.rr_
ASIA: asiaabella
Otilia Rosales Gonzales: otiliargonzales
cole helmcamp: chelmcamp04
CHICHI: chivsh
Brenna W: brennalw2004
elle jolie: ellesanger
Ali Wayman: aliwayman
Estela Martinez: estela.martinez.5076
nathalie: natbug7589
autumn rose: autumn.haney
: ella_porter31
Tisha Pradhan <3: tishaprdhn
Leander High School c/o 2022: lhs.co.2022
sophie roper: sophieroper_
Abby: _abbyflynn_
Michael De La Garza: michaeldelagarza_
Yvette Betty Geigenmiller: noobbetty
kate sterin: katesterin
~vickyyy~: viictoire.e
John Marian: johnmarian_
alyna: alyna_j03
luke: lukehweber
Rodney Nabors: renabors
Sam: sam.hoskere
Aria: a._.aria
Ella Romboldi: ella_boldi
: isabelll353
Kendall Owens: kendall__owens
Chris Puckett: cspuckett
