kaitlyn: kaitdmorris
amanda kell: amandafaithkell
alex levinson: _alex.levinson
Dhillon C: dhillonc9
lexie miller: lexiegmill
JANIE: j.bickerton
jessica: jessicaselvarayan
Jesmin Simon: jesminsimon
Simon John: simonkjohn
Anna Moore: anna_e_moore
kirthana: kirthananore
evelyn lee: _.evelyn.lee._
ava: avajanakk
Jeanne de Moucheron: jeannedm_09
emmie cawood: emmie_cawood
emma: emburrell8
ash: ashleymoyerr
aashna mangal: aash.na_m
kenna dahlberg: kennadahlberg
: danifriedman_
Sophia Fente-Damers: sophia.fente
emma a: emma.abelkis
emma: emmagfarmer
dev: dev.21_04
Dhruv: dhruvp04
• Diana Pedroza •: diianax
Neha Deosthali: neha.deosthali
ainsley: aathiemm
: timiluvsu
emilia !: _emiliafong_
Gracilyn Hardy: gracilynhardy
karí :): _karina_ila
Michael Sendejo: its.raining.tuna
Noah: n.chung1
sandra garcia: sandrapaulinagf
: and.rea.x
Jordyn: jordynfeenberg
peyton:): peytonhilfinger
Giana Abraham: giana.abraham
Varia Sufueva: variasufueva
Natalia Vazquez: nataliacvazquezz
Sofia White: sopapillaaaa.__
Jonathan Michael Teubal R.: jonathanteubal
mads: maddiepopp_
Alexis Hansen: alexisahansen
: alhawchappell
Visruth Chakka: visruth_chakka
vani: vani_shaah
Vineet Puranik: vineet_puranik
VIV: viviankbrooks
Albert Vierra: albert_vierra
Jose G. Jimenez Viramontes: jose.jimenez13
Elizabeth Lok: elizabethllok
maddie: madisonnmcdowell
ELISE MORAN: eliseemoran
Tessa Howe: traehowe01
: gonetotexaswanderer
Denise Bava Howe: teamhowe5
Nathan Pannell: nathan.pannell
sanjana: sanjana.khanna_
ainsley:)): ase_722
payton!: gwynnpay
LILLY CARLSON: lillycarlsonn
Alyssa Klein: alyssakleiin
Orlando Rodriguez: orlando_6634
Ramsey Perez: itsramseyperez
Emeka Bielonwu: emeka.03
Izcan: izcan.ordaz
: dana._lee
Chase Smyth: chasesmyth
caroline erb: carolineerb_
MIA: mia.catanzaro
Maria Paula Aguilera: mariapaulaaguilera13
Zoey :)): _zoeypaige_
Mackenzie Cashion: mackenziecashion
Natalie Jakobsohn: njakobsohn
manny: manny.delacerda
egya reddy: e_reddy19
Ronald Dymesich: ronniedymesich
Aldo Frausto: aldo703_
Evelynn: evelynn635
pspspsrose: deismos
Jared Orkin: jared.orkin
: ella_porter31
Lauren Wilson: _lauren.e.wilson_
Zeynep Ertuna: z.e.y.n.e.p_22
Idalee Grande: idalee_x0
Myles Johnson: myles.johnson04
Villas on Rio: villasonrio
b r o o k s: beyondbr00ks
Aditya Sangana (Airbender): adi.s.7
Ariana: aripear_
Collin Caballero: collincaballero
x i x i: xixi.hillman
o l i v i a :): olivia.pettis
Adam: adam__ily
l i a: lia.hoang2022
Adriel Bustillos: adrielb.08
taylor lin: t.tayyylor
nicholas: nicholascristan
kind of kind: kindofkind.tx
Michelle Ferguson: michelle_fergie99
Kelsey: kelseychase13
Angel: angel.nolasco04
Aidan Manning: amanning___
hannah: hannah.fialho
Gini Dyer: ginigdyer
Francesca Disanto: francesca.disanto
Henry Roth: henryroth10
Aine Flaherty: ainebensonn
giovanna <3: giovannamcleann
juliana hager: julianahager
ava h.: aavahalee
McKenna Bayless: mckenna.bayless
Caleb Fleischmann: calebfleischmann
Joseph Franklin: josephjo.frank
Alejandro Lopez: _alejandrolopez4
jocelyn: jocelyngarciabarb
emma: emmadegarb
jess: jesssilverstein
Jennie: _jenniebonnett
: kassandra.jimenezz
logan :): loganvitagliano
Dishita Awataney: dishthefish2194
Theodore Daskalakis: tydask
Emma Dobbs: emma.dobbs03
isabella martinez: isabella.martinez22
apoorva :)): apoorvagobburu
ANA: anapaulakendrick
: mariahshanklin
RyAnne Rovelo: ryannerovelo
Mary Jasso Delgado: maryjassodelgado
Vaishu: vaishumarreddy
Prisha: prishamultani
Ben Puckett: benjpuckett_
Maya Pasyk: mayapasyk
Jai Ramgopal: jai.ramgopal
paula: paula.noriegaa
ericka pugliese: erickapugliese
mariana peña: marianapennaa
Penelope LaScala: pvl620
Joseph: jco.roland
Zion James: thezionjames
Parker Colley: parker_pdc
: taylor.felton
Joaquin Rolando Chapa: savagerockerjrc1
Ranudhi Nanayakkara: ranudhi_nanayakkara
Quinton Mendoza: quinton_mendoza
Justin C.: jstn_n_cln
braeden: braedentidmore
Remy Tran: r3mytran
Isabela Salazar: salazar.isabela03
: _.mpl_4l
Isabelle de Janon: isadejanon
Adnan Dollar: dollar_in_the_house
Tuvan Dinh: tuvan.d.356
Victoria Lynn Rodriguez: victorialynn21
Mathew Jasso: jassomathew
Esteven Christopher Polio: esteven_polioo
kiya: akiya.b
crystal zimmermann: crystalzimmermann_
Samantha Lee: samfaithlee
Lauren Silver: lauren.silver
Allyson Rodriguez: allyyy_rodd
kate white: kategwhite_
Mina Jeong: _minajeong
David Padilla: daviddpadilla
Cole Sorosky: cole_tyler27
marifer !: marifer.gnz
Jana Madi: janaamadi
alexa: alexanuncio
aiden: aiden.tijerina
Abhived Pulapaka: abhip636
: howyouknowpenn
vashed<3: vashedthompson
katie schott: katie.schott
hayden king: haydennkingg
kate sterin: katesterin
evelyn: evie.conwayyy
Kate Calderwood: kateqcalderwood
kallista:): kallistafogelsong
Kate Kittleson: kate.kittleson
Magnified influencer awards: magnifiedinfluencerawards
mady kahn: madykahn
josie lin: josieilin
Lex: alexa_smigel
Lagunas, Bethany: betania.1
Kelly Do: _kellydo
Hiba: hibasoban
kira berzack: kiraberzack
Dylan Waguespack: dylan_waguespack
Alexis Hunt: alexis_hunt_
Charlotte: charlottegbrown_
MADI: madibbourne
Jennifer Drake: jennifer.drake.716
saachi: saachi.mehta
Camila Marden: camiiiii.i
Robert Behmer: akabob7
: l3naaaaaaa
Rimsha: riimshas
melissa: melissaa.tran
bella !!: iisabellagonzo
Ali Wayman: aliwayman
gracie lynk: gracie.lynk
Anay Patel: anay111803
Lauren Rose: lauren.rose3
yubin <3: yubinkkim
shreya goel!: shreyaaagoel
chloe gatlabayan: chloshai
ankitha: ankitha_194
kelly: kelly.matthewss
Katie Hardesty: katie_harde
annalise: annalisebelzile
mairany: mairrany
Chloe Robinson: chloemrobinson
sanya <3: ssanya.g
•Meredith Rillera•: meredith.rillera
Galit Beraja: galit.beraja
ISABELLE GREEN: isabelle.victoria7
Jacob Sedlacek: sedlacek.jacob
sara kate !!: ssarakatee
Isabella Alvidres: isabella.alvidres
Annika: annika.gabrielle
Madelyn Leonard: madelyn_leonard
rishitha: rishitha_v
shivani: shiivaniikumar
Ryan Qu: r.quuuu
Brown Mundeee: 12thebrownmundeee
Scottish Rite Dormitory: utsrd2026
jessica: jessicanorthh
Trinity: trin_train
kendall :): kendall.quick
Roberto Garza: rrobertogarza
Isabella: isabella.sruiz
alea lastinger: alea_lastinger
schottman: elly.schottman
Jovdat Rahimli: jovdatr
: luisc.bonilla
Madhu sharma: madhuhhvsharma
Yadira: yadira.vega.0024
Jungmin Kang: itsjungmin
Camila Kristiansen: camila_krist
mihika: mihikapatankar
zakaria amor: zak.amor
lilly ashmore: lilly_ashmore
m.: marianaabenavides
Taylor Lewis: taylormarieeeeee
EMMA GRACE ALVEY: emmalvey
: jt_shapiro10
nisha patel: nishapatell_
Aastha Agrawal: aastha_agrawal1
Aneesh: aneesh.harwalkar
Mia Wurster: miawurster
Abby: abby.n26
Trent Kinder: big.trenton
Dave: dave.nwaneri
Roberto Vega lll: nou_975
zoe lemaire-jones: zoej217
Dane: dane11175
~ Arianna ~: ariannaaa.jimenez
Zach Boehly: zboe21
emery: emeryjjones
kirsten: kirs.ten909
nicole: nikki_hilscher
Amitabh Kunchey: festus11725884
jacob arango: jacobarango
William: anonymous_30000000
Halimot B: halimot_b
crys: crystalsdelgado
Mason Tucker: _mason_tucker
Hunter Tran: nothuntertran
jules :): julesmurillo4
jenna struck: jenna.struck
Julian: jujubeanbb
jacqueline saenz: jacquelinecsaenz
jacob hernandez!: jacobh.04
jackson sacher: jackson_sacher
vidhi: vidhisapru
Billy: disastrous_paracetamol
Zach Arenberg: zarenberg21
sydney: sydneydlai
Daniel McIver: thedanielmciver
Maria Tortorelli: maria._trt
Ben Hamel: benhamel1
aashika: aash.ika
Elizabeth Scott: elizabeth.sscott
Wilson Somarriba Santos: santos5021899
Zaria Cleveland: itsjustzaria21
: katelynherbold
ainsley burns: a1nsleyburns
paco cheung: cptpaco831
Sara Burris: saraburrisss
Makaila Van Buren: kaila_vb
hannah: beanerkween
bella margolin: bella.margolin
Sofia Di Salvo: sofia_di.salvo
ally: allybellsnyder
bri <3: brianna.mcghee
Christoph: christophxklein
• Z I N I A •: zinia_maknojia
ella burgess: ella.burgesss
Anika Chandwani: anikachandwani
ava: avamesghali
Miloni: miilonipatel
Megan Trieu: megan.trieu
syed: the_bebopp
felix !: ffelixjegede
zev gordman: zevgordman
Zach Adler: zachadler1126
Elyse Rosario: elyse_shelli
Isabella: isabella.y.wade
Zona Johnson: zona.johnson
mirhanda cardenas: mirhanda.z
zare: zarekokic
carolina carrizales: thecarolinacarrizales
kenzie: mackenzielautnerr
Storage Scholars: storagescholarsut
Sorority Prep: sororityprep101
lilah bowers: lilahbowers
Mayy Alsawfta: mayyalsawfta7503
lily: lilyemartin
natalia orejas: natiorejas
siri: _sirib
Suzeth Roman: suzeth_roman
Maya Richards: mayarich03
A L E X A M I L S C H: alexa._mg
Will: will_29455
arianne tsioutsias: ariannetsioutsias
mackenzie: mackenzie.coop
sophie sorkin: sophsoph04
lucy.: lucyybergerr
Cmarsh: carson.marshall
: preston3llis
Talon: talonblottin
adi dass: adi_dass_
Samantha L.: sam_leidel
Mary: maryccreel
: irgennnnn
<3 T: taylor.k.anderson
Christy Lovoi: christylovoi
julia schwaeber: juliaschwaeber
tami adio: tami_adio
Will Townsend: will.townsend03
audrey: aud.sperry
emma cate: emmacategall
Delaney: delaneypolocheck
ashley pfeiffer: ashley_pfeiffer23
: christianpereez
kate mclane: mclane.jpeg
Netra: netra_krishnan
London: llack_124
kalea: kalea.caldwell
Alex VonHaven: 8_alex_v_8
Leila Rabah: leila.rabah
michelle: michelleeerivas
emi: vdzemi
Alec McGhie: alec_mcghie
Libby: libbymtempleton
: puzzleman568
K I Y O N N A: kiyonnakapoor
olivia gonzalez: olivia8gonzalez
Matthew Shapiro: matthewshapiro_
Jamie Ordonez: haiiimeeee
Allison L.: all.is.on56
Hasan: hxsanmurat
katie roque: _katieroque_
Paulina: pauuvictoriaa
Kristine <3: krissycaridad
laura haas: laurahaas12
Nerwen Cao: caoyuqing130
masyn!!: masynwernecke
Clark Edson: clark.edson9
: megan.dedmon
Alison McDougall: aliemcdougall
pommo: maddiepomykalski2
Nayeli: _nayeligonzalezz
emily escareno: emily.escareno
Autumn Beck Blackledge: autumnblackledge
Pehlman “Anything Is Possible”: carsoooon_peeeehlman
Julian C.: juliancastillo__
issie: issiemagee
Coralynn Cole: cora_god_and_photography
Justin Billey: justin.billey
G I A: giaperel
Lauren Darzy: laurendarzy
Lillie: lillian.kate
Leylah Attia: leylahattia
Lilia_Oberlin: selena.bartholowmew
kat: kathryn.thomasonn
Taylor Gardner: taylorgardnr
Sydney Willoughby: syd_will22
DylBob: dylbobmart
Jordan Norris: jordannorriss
bianca cooper: bianca.coop
Bella :): bellablohm
: woken_soul10
Kimberlyrobin97: kimberlyrobin9797
devin chaky: devinchaky
bg: brooklyn.garza_
Gabriella: gabbycarvelli
talia giannini: taliagiannini
Adriana: a.desalos
: genevievehendrie
Susanna Brass: susanna.brass
Lauren Dunlap: lauren_islegit
Marcella Hilmi: co__cella
Betty Weaver: bettyweavertn
Emilia: emiliatornoe
jacob umbarger: jcumbarger
Ben Wells: benwells15
Chloe Bennett: chloe_maybennett
morgan bangert: morgan.bangert
Arshia: t__arshia
Nora Leal Troxell: n.oratrox
jarykah rios: jarykah_55
Genna Adelizzi: genna.adelizzi
Danelo Ibis Gonzalez III: danelo_g_3
Peyton: peytonccasey
hannah: hannahtooleyyy
Calvin Mauldin: calvinmauldin_
Olivia Rocha: oliviarrocha
Santiago Ortiz: santihortiz
Stephanie Calderon: stephaniecalderonnn
Kendall Smith: kendalls2700
fiona: fionacosgrove_
Texas Universities 2026: texasadmits2026
Kayla Ngo: kaylaxngo
Kenneth Garcia: kennethggarcia
Olivia McMillian: oliviamcmillian
Kylie Jo: _.kylie_jo._
Evan Craig: craigohaslosthiseggos
maya orenstein: mayaorenstein
chong :): elaina.chong
isabel redwine: isabel.redwine
Melanie Charron: mel_charron4
milla gideon: milla.gideon
Patrice: patricehayes_
Miguel Gonzales: m.gonzales_12
: mae.erinn
hannah smith: hannahsmith_324
Blair Sayers: blairsayers
Tori: tori__deawesome
LEXI: alexisdmalone
kate: kateaaguayo
becca:): beccarincon
Noble 2500: noble2500apts
Kobe: kobechronicles_
Eliana: eliana.is.a.stud
Sarah Greaney: sarah.greaney
arielle: a.ria.lle
ava: avadawson2
: emmakpardue
Jess: jesssgallo
: k.redrick
Lorenzo Lavigne: lorenzo_lavigne17
ELISE WEBB: elisewebb
: yousefkamall
gabby :): gabby.d82
aditi k: aditi13k
Chloe Miller: cchloemillerr
Luke Schweizer: schweizerluke
Alex Hoke: alex.hoke
jC: bisou.j
Thess <3: thessabelchang
lcm ‘22: tatum_howard
mimi <3: milicakonatar
Sanjay Sivakumar: s.sanjay011
Lauren Murphey: lauren_murphey
fran: _francenne_
leah :): l3ahbea
: taylorrhoadess
dani: danielaipatino
camryn: camryn.courtney22
3mma: yar3mma
shaili shouche: shailishouche
brooke <3: brookedauderman
Reyna Shah: reynashah_
Elle McRae: elleemcrae
Sydney Hunt: sydney.j.hunt
catelyn: caty.the.unicorn
emma: emmaaamoncur
Ryder Phillips: ryder.phillips_10
zeba: zeba_morani
Brighton Mooney: brightonmooney1211
Milan Patel: milpatel11
Regan Perrin: reganperrin
shan: shannonmcgovernn
reagan: reagannnbrownnn
Liam: liamstemetzki13
Bryce Strongin: brycestrongin
Izzy: izzyg1955
katelyn ritter: _katieritter
Reese: reese_winn
[Ireland Blouin]: ireland_j.m
kylie prince: kylieprincee
varshini: varshini.chinthareddy
Liv: livschlossman
Leah Lavoie: leah.lavoie
landry: landry.kern
Ava Acton: ava_acton
Gabe: gcweaver03
Raiyan Amin: stunnasaad
mina gollogly: minagollogly
jada kabani: jadakabani
kayla: kayla.sorge
: megward06
anna kolbe: annakolbee
lauren engates: laurenengates
: swlkrrr
soph : ): sophie._.broom
sophia campbell: sophia.renn
KAELEY ROBBS: kaeleyrobbs
anjali: anjalibaratham
Phia Parent: phiaparent
hannah: hannahtthai
adi: adison.viars
Hampton Pillsbury: h_pillsbury
harper: harper.cunningham
ally: allywinburne
John Marian: johnmarian_
Carly Barnett: carly.barnett
Will Aronson: will_aronson1
Lili Tomko: lilitomko
frances di carpegna: francesdicarpegna
Finn Warren: finnwarren_
wirickjacob: jacobwirick_15
meghna subramanium: meghnasubramanium
Charlie Satenberg: charliesatenberg
Anthony Okeke: its.only.okk
diya bhatia: diyabhatia27
ASIA: asiaabella
Valerie: valll_770
trish: trishad19
Julia Genin: julia.genin
laura: laurasalazarrrr
Arthur: arthur.blake
maddox: maddoxmyane
Natalia Ortega: natalia2ortega
jordan lovoi: jordanlovoi
Amie Nguyen: amiednguyen
makayla anne matney: makaylanne
Jessica Mikell: jessica.mikell
Adelle Hinson: adellehinson
Grace McGrath: gracekmcgrath
Jamie Brooke: jamieweinbergg
aynoa casavantes: aynoa.c
Jaiden Clark: jaiden.clark1
Rosalinda Perez: rosalindaperez4002
Deba Osague: deba_osague
Mia Rosenberg: miaarosenberg
Corinne Piorkowski: ccorinnep
claire: claireschulter
Peyton: peyton.abbott
GABRIELA: gaby.marquez_
Will Peters: willpeters03
Ally: allyyjewelll
izzy b: izzybba
: sterling.elyse
Shelby Rose: shelby.yeary
Alexander Dunaway: alexander.dunaway
Carly Freeman: carlyfreeman5
Anna Kate: annakatekelly
Sydney Erales: syd.erxles
matthew bustos: matthew.bustos_
Katie Morgan: katiemorgannnnn
nick n: n.ng04
behr rinke: behrrinke
Omar Almeida: omar_almeida11
Prisha Mehta: prisha.mehta
AUDREY KIRWIN: audreykirwin
Hannah Koepp: h_l_koepp
Jadrian Rodriguez: jadriianjay
: carlyymccausland
sydney lamphier: sydlamphier
Molly Garvin: mollygarv
Dinah!!: dinahsaur_t
Aditya Behre: adibehre
amadee garza: amadeegarza
talayeh: talayeh.higgs
welbeck crowther: crowther_welbeck_rashid_
bella b: bellacpaz
shrika ;)): shrikaaa
Olivia Martinez :): livi04m
Jerome: jerome_kai11
Riley: rileytendler
Tommy Vahalik: tommy_vahalik
Aidan Leonard: a1danleonard
Ignite Texas: ignitetexas
Katie Poulter: katieepoulter
Emily Estes: emilyestes22
Anna Claire Frolichstein: annaclaire.f
Lily Barrow: lily.barrow
ruby bixby: ruby_bixby
Likhita Velmurugan: likhita_v
holly keenan: holly.raico
zeena: zeena.karkaria
Jonathan Nachman: jonathan.nachman
Jonathan Xi: caiyujonathanxi
Preston Byrnes: pbyrnes5
Yuri Lee: yuriii_lee
allison:): x.alli_son.x
priya n herman: priyaherman
: isha.ramann
abigail june: abbydeyoung
Alexis Headrick: aplexx990
Naman Bhakta: namanbhakta051
Rylee Cooper: rylee_rooly
maja: veracmaj
Keira Rusinko: keirarusinko
Briana:): briana._.zuniga
ash manoj <3: ash.manoj14
eleazar: rawr_its_eli
luke: lukehweber
Maddie Savasky: maddiesavasky
Nikolas Parker: parker.nikolas
catherine: catherinecutbirth
conner escobar: conner.escobar
Katie Cohan: katie_cohan
Will Stone: w_stone1
: rahulabraham03
myranda duran <3: luv.randa
Vivek Patel: vivekpat.el
Maryam: maryamelbeltagy
roselyn: rosssselyn
Imelda Delgado Trevino: amom_22_boys
brooklyn: brook1ynd
Abby Daehler: abbydaehler
Roopa: roopsy.daisy
TJ: itstjkohli
Anagha Natarajan: anagha.natarajan
Lj: landon_kaley
Shalini Parepally: shaliniparepally9
Carlos Hinojosa: _carlos_hin0
Cam W.: cam.books4124
audrey bredehoft: audrey_bredehoft
emma calhoun: emmacalhoun_
Ishita Jain: ishitajain1001
LittlePancakes: thelittlepancakes
Austin: austin_friedman13
Allie Singer: allieesinger
Jenna: jennaabulughod
bella: bellsdom
sage rose: sagefuhrman
iliana dentchev: ilianaamariaa
Abigail Quintero: abigaillquintero
Noah Tyson: noahtyson03
Chantz Bell: takeachantz_
tanay bawa: tanaybawa
Sejal Goyal: sejalrgoyal
chloe: chloefeyerick
surina: surina.19
Erin Brogan: erinbb42
Mario (Felix) Sumali: luigisumali
Frensley Smith: frensley_smith
kara paige <33: kkaramorriss
Aly Lucio: alyanaluc
mel: melat_w
luna: lunareichert_
julia: julia_thomas04
Daniela: _daniela_2624_
sarah love: sarah.macjones
Walker Francis: walker_francis
Logan Wright: logan_lt40
Otto: ottokirchof
lauren :): lauren_.simpson
summer :): summer.fugere
Josh McKenna: joshua_mckenna868
avery schilling: aveschilling
Andy: andres_garciajr
ricky: ricardoo.ortiz
Akshar Amin: akshar1010
Ashley Goforth: ashleykaygoforth
ariel: arielbarley
Mahdia Rahman: mahdiaaa._
Ethan: howat.ethan
adonis: theoreticaladonis
G: giuseppa.sanfilippo
marlen: marlenjuarezz
soni: sonii.shukla
Lily Gray: lilymelhorn
maekayla effinger: maekaylaeffinger
melanie: melaniebardaless
Linz: lindsey.hughes
Richie Raclaw: rraclaw20
alyssa: al.yssamarie
Colin Felan: colin_felan
Christos “Taki”: tpsaropoulos
katz: katiaa_bc
teresa: teresas.dj
Jay Namdhari: jay.namdhari
Ashmit: ashmit195
raunak: raunakmanchanda
Sophia: sophia.3100
Audrey Gilbert: audrey.gilby
Lizzie Coyle: lzcoyle
Tracy Weng: tracyyweng
Pranav Akkaraju: pranavakkaraju
Ainsley: ainsley_nelli
Marely Hernandez: marelyh3
Nihal Mohammed: nihalmhmdd
: thisisjust_an
tanisha padhi: tanisha_padhi
Shayna Setoudeh-Maram: shaynasetoudeh
Sergio: sergio.t__
Jill Zhang: hzjill
Ashwin: as.hwinn
Cami Morataya: camilamorataya_
isabella: isabella.ravden
Dorothy Macias: dorothyalexis__
jerry: jerleecab
parker: pholland.14
Evan Woodward: evan.woodward
Samantha!: samantha.dahlin
Ericka Dusek: erickadusek
Brooke Williams: brooke.a.williams
Ruby Manley: rubymanleyy
CAROLYN KANE-BERMAN: carolyn.kb
Donna Waitkus: donnawaitkus
abby: abby_hecker
Reagan Schluter: reagan.schluter
Hannah Wehofer: h.wehofer
teresa nieto: _teresanieto
hannah: _hannahcleveland
Pari Latawa: parilatawa
mike: _michaelsuarez22
Riley Smith: rileyy.s
Nate Martin: nate.martin6
Avery Alvarado: avryalvarado
khushi: khushi.gandhi
Payton Thurman: payton__thurman
Maddie Hymowitz: maddiehymo
danika: danika.gonzales
emma jakala: emmajakala
Kylie Finkelstein: kfinkelstein
Shayna Meek: _shaynameek_
Morgan Davies: morgann.davies
Anna: annagreen04
Stephanie Jumper: stephstephj123
had: hadley.olsen
Olivia LD: olivia.j.ld
Ellie Hague: eahague99
micah barker: micahbarker_
grace!!!: grace.stern
nathan: nnathan.kim
Victoria Mentzer: victoria.mentzer
KG!!!!!!: kgestess
Ryan Karkowsky: ryankarkowsky
Seth Hendricks: sethbhendricks
Odette Saenz: sarazensara
Bailey Evertson: bailey_reese22
Sofia Elisa Cabello: sofia_cabello3
kate winston: kate.winstonn
ava thomas: avaa.thomas
Kohlton Mathis: kohltondmathis
Byrdi Beggs: byrdi_maye
Alexis Carlisle: alexiscarlisle2022
Taylor Eckel: taylor_eckel
Cate Casey: catecasey_
ari b: arianabhimani
: jacksabo_
Addie Lilley: addie.lilley
hayden miller: haydengmiller_
lauren parker <3: lauren.0.parker
Breela: breela_m
yanely: yanelymolina03
d: diana.valdiviia
Lauren Misencik: laurenmisencik
Jewell cooper: jewell.c0oper
JULIANNE: juli_chapa
jahnelle: jahnellemata
tyler: tylerkpeterson
lauren lindemann: laurenlindemann_
Mo-P: mo.noelleee
Vanessa Nguyen: vanessaanguyen
kaley<3: smith_.kaley
Mary Louise Buchek: malou_buchek
Serena Syed: serena.syed
catia rodriguez: catia_rodz
Cody Hall: codyhalll_
Braxton Little: braxtonlittle900
Sriya Dommaraju: sr.i.ya
aj gamez <3: aj.gamezz
kt: katiesiddonss
Josh: josht2022
Alicia: alice_ia.rose
Lily Kent: lily._.kent19
Victoria Lee: victoriatheleek
Sofia Frey: sofiafreytx
laura: laura.merlina
Tommy Bannon: thelifeoftommy_21
Alexa: alexa.yeager
Ellie Basta: elliebasta
Megan: meganknightt
nij: nijkoirala
: _._jinna_._
Ava Wiederaenders: avawiedey
Sarah Catherine: sarahcatherinecrow
Lily Davis :): lily.davis24
avery: averyengleman
UVA Class of 2026: uvaclassof2026_
ANNA SCHLETT: annaschlett_
anna montgomery: montgomery.anna
larsen <3: larbsxd
Georgia Ann: georgia.everetttt
[2600]: arcxenon1
Shivani Jariwala: shivani.jariwala_
evanuel: evanhho
BELLA FRIEDMAN: bellafr1edman
paige: paige.strole
chloe romero: chlo.romero
raely fitch :): raely.f
george: georgiaposey
lizbeth Varela: lizbeth_varela_
Mar: maritza.mcneal
Madison: _madisonconn
gabby: gabbybesnard
ENA: ena.k
isa: isa_garzaa
Luke Miller: lukemlr
Dorina Balogh: dorina__balogh
sof: sofiefinch
m a r i s a: marisakapavik
Andrew Daitch: andrewdaitch_
catherine: _catherinebui_
tatom: tatom.hoffmann
R I A: ria.narayanan
daniela: danicontrerasojeda
gauri: gmishr4
becca!!: beccabalan
allison: allisonjyang
Cameron Parham: cameron.parham
Lily: lilypennock
Aliyah Banerjee: aliyah_banerjee
Aryan Samal: aryannn.samal
Paige: paigemeridian
emma houston: eemma.leighh
sabrina merkle: sabrina.merkle
carly gaudin: carlygaudin
jas: jasmineeweng
rhea :): rheanna.patel
Olivia Swonke: olzswonke
Melissa: melissajhaveri
RenRen: dashay348
naylea valentina: nayleaaa
Genesis: genesis.r.p
: marvizzworld
Terri Thomas Herring: terri.herring
Ryan Couron: trexcouron
Steven Mascolo: steven.mascolo
Jonathan: jonathan.marez32
kendall karoline :): __kdoll__
Marlene Pineda: themarlenepineda
Ellington Hull: ellingtonhull_
kyrielle: kyrielle_1
camille gm: camille_agm
pri: bittersweet_pri
: michelleofoegbu
Wynter Winston: wynterrwinston
Destin Drummond: dezdrummond
skylar stepp: skylarstepp
Matthew Padilla: themattpadilla
myles: myles_awayyy1
premanshi: anshi.agarwalla
regan walker: reganwalkerr
Hibbett 672 of Temple: hibbetttempletx
Bella Gomez: isabellaegomez
Charlotte Eades: char.eades
Rohan (Rappin Ro): rappin_ro
Juliana Sarria: juliana.sarria
a v e r y f i n k e: averynfinke
Yasmin Jenna Jackson: yasmin_jenna_jackson
Sophia Steinauer: sophia.steinauer
•sophia black•: sophiablackk_
Robbie: robbie.valcarcel
lila: lila_orr
Hector Muniz III: hectormunizz
ania davila: aniadavila
ARIEL DOSS: arielmargaux
Brooke Rogers: brookerogers08
Emma Elizabeth: eliiizzzabeth33
Ryland Marshall: rylandm23
Andrea Aragon: andreaa.arag0n
Jack Staton: jack_stat0n03
Sydnie Simon: sydnie.simon
Mary Katherine: mkpalmer_
gaby zurita: gaby.zuritaa
Gpace: gpacehub
Julyssa Cantu: julyssa_cantu
Kaley McKinney: kaleybmckinney
katelyn perryman: katelyn.gp
Sarah Shelton: sbshelton04
Katelyn Puello: katelyn.mia
kaunli: kindred_kind
katherine: katherineethomsonn
Sydney White: sydneydanielle_14
gracie leal: gracie.leal
kennedy :): kennedy.a.baker
trevor hopkins: trevperro
Kyeongseo Choi: 04kyeong
Emma: emma.nicole.m
amber liu: ambersongliu
Katherine :)): katherine_nix
hailey!!: hailey.mp4
caroline: sugarspiceandbadadvice
Sourik Sannigrahi: sour.ik
Isabel: isabel_dahl
Annika Philippi: annika.philippi
Jade Sierra: jadesierrra
hailey hirsch: haileyhirschh
Lucienne: lucienne.moran
Abby: abigailrodionov
makenzie: makenzie.long17
Eleanor: eleanoranderson__
Sasha Amos: famousamoss__
Dominique Maldonado: dom_._._marie
Alysa Madriz: alysamadriz
isa almeida: isabellagomesa
libbie brown: _libbiegrace
Chuck,Garcia: chuck_01272003_
Lucy Simon: lucysimon_4
vivian montoya: vivianmmontoya
cassie: caasssiieeee
Whitney Reid: whitneyreid_
Salma: sallisal15
Sarri: sarrionna
helaina gilmer: helaina_gilmer
ava richards: avaann.r
Tatum Eades: tatumeades
Ryan Spier: ryan_spier
Diego: diego.45c
Lalit Metta: lalit_metta
Tori: victoria.rodd
Emma Nagle: _emmanagle
Heath Harris: heath.harrisss
Lizzy Pistone: lizzypistone
halle schenk: halleschenk
Elise Morrissey-Rocha: _elise_autumn_
Reeba Abraham: reebabraham
Reese Gutshall: reesegutshall
Mary Nelle: marynelle_cravens
bren <3: brenleefox
selah: selahnorton
kenady: kenady_cooley
Anjelina Ortiz: la_anjie
alyssa lane: alyssalane._
Carson Domey: cjdomey
marissa: mariissa.ann
madisen lieberman :): madisenkate04
Olivia Gerhart: livibeannn
: madisonpoopoo
diya khattoi: diya_khattoi
Megan Lam: megandlam
caroline cullen: cvroline
Alex Scott: aluke.scoot
aidyn neiman: aidynneiman
sri: sri.chandrasekaran
Maddie Paige ™: madell._
• virginia nussbaumer •: virginia_nuss
krissa:): krissajhaveri_
Kai Hernandez: kai_hernandez_
Sydnie Karel: syd_karel
annika lærum: annikalaerum
Saleen Nyman: saleenbelle
Sana Kohli: sanakohli1
Perise Sasa Siaosi: p.erise
nat: natalielongacre
Gabby Norman: gabby.a.norman
Les: leslyyy_cruzz
ella grace: ellagracewhite_
Katlyn Huynh: katlynhuynhh
ut ‘26: aidanscottchristensen
Aubrey ShyAnn Clayton: aubrey.shyann
Dylan Recker: dylan.recker
chris lopez: nuychris
~WHITNEY~: whitney.shayfur
AVERY SCHWARTZ: averyschwartzzz
maya: mayapai_
Lilly: lillyredwine
Gabby Aguilar: gabby.aguilarrr
Liv: oliviavarcalle
Mia: mia.latigo
rebecca: rebecca_oladejo
A.P.: allisonpow3ll
abi: abigail.jolie
Taylor Walker: taylorwalkeer
william: thebillymcnamara
Mala Gupta: malagraceg
sanjani: sanjaniseetepalli
khalil :)): _khalilmalik
elle jolie: ellesanger
loran johansen: loranjohan13
mads: madison.demauro
Maya Walker: mayajwalker
Elaina Hamuy: elainahamuy
Leslie Gonzales: lesliie_g13
Maxwell Diamond: maxwell_diamond21
shelby campbell: shelbyhcampbell
S O P H I E P A S C A L: sophiexpascal
Maddie Mandel: maddieemandel
Cate: cateadamss
maddie: madelynaolive
Hailey Garza: haileygmarie
Abbie Valdez: valdez.abbie
lu bierrenbach: luisabierrenbach
Sadie: sadesandsmiles
kennedy renae: kennedyrenae_
Iyosias Hailu: iyosiash
averie varnado: averievarnado
parmida: parmidakhajeh
keiley tierce: keiley.tierceee
Varun Vedala: varun_vedala
Akshay Pradeep: akshaypradeep2004
shruthidandamudi: shruthidandamudi
marin: marincroix
Sneha Joseph: sneehaj
amanda: amandafoy_
Colin Angel: colinjangel
emily: _emilyboler_
Austin Gardner: austinthescholar
keelin <3: keelin.finley
Morgan Marie Hernandez: morgan_m_hernandez
: kynadi.jones
margarita ovalle: maggieovallee
Jaqueline Del Angel: jackie.da
carolyn hendrix: carolyn_.anne
Dani Rose: danimirin11
mahek dodani: mahekk.d
Grant Brewer: gm.brewer
: amandaharrelsonn
Ali Zaidi: alizaidi_04
Nehir Aran: nehir_aran
Natalia: nataliaia.m
taco :p: bela.davilaa
christianna m.: chr.xssy
sophie cain: sophieecain
Vik Gokli: vikgokliii
anvith: anvith_reddy666
dw: dawson.wolff
chenyi: chen.yi.wang
fernanda herreria: fernandaherreriaa
caleb :,): cal.eb24
sanjana: sanjanadandu17
Bella R: isabellaflorencee
samantha: samanthawlodawsky
hope vanderburg: hope.vanderburg
JACKIE PILLOW: jackie_pillow
Brock Williams: brockthebeast03
Matthew Martinez: _mattmartinez
R Y L I E: rylie.clark
Esteban Elias: ea_elias02
Alyssa Osorio: alyssa.anahii
Jackson DeBorde: jackson.deborde
hannah nixon: hhannahnixonn
kourtney miller: kourtneyymiller
Jacob Lee: jaccob_._
: avabarrera
NICOLE KULA: nicolekulaa
