CertifiedCountryLemonade: certifiedcountrylemonade1
jordan lovoi: jordanlovoi
camille gm: camille_agm
Andrea Aragon: andreaa.arag0n
Shivani Jariwala: shivani.jariwala_
Allison L.: all.is.on56
myles: myles_awayyy1
Melanie Charron: mel_charron4
Charlotte Eades: char.eades
Maryam: maryamelbeltagy
Alexis Headrick: aplexx990
carly gaudin: carlygaudin
ENA: ena.k
Nevaeh Galvan: nevaeh_gal
Advik: adviksun
zoe lemaire-jones: zoej217
Mary: maryccreel
: mshea_28
chenyi: chen.yi.wang
Madison Baer: madisonbaer72
Waamene Yowika: imsognarly
Christoph: christophxklein
lily nguyen: lilymnguyen
taco :p: bela.davilaa
Jared Orkin: jared.orkin
Ayden Lalani: aydenl_25
anjali :): anjalicherukuri
: yousefkamall
paige simpson: paigehayley.s
Leslie Gonzales: lesliie_g13
Austin Gardner: austinthescholar
Pranav Akkaraju: pranavakkaraju
Kimberlyrobin97: kimberlyrobin9797
Sam Lu: presidentsamlu
: akshita__
Ali Zaidi: alizaidi_04
tamara: tamarajrhodes
Nathan Pannell: nathan.pannell
Alysa Madriz: alysamadriz
regan walker: reganwalkerr
Amrutha Ayyappan: amysunstar04
Grace Hare: _grace.hare
Jenny Cope Warden: jennyw6
Nihal Mohammed: nihalmhmdd
Carol Gerges: carol.gergess
Sarah Catherine: sarahcatherinecrow
avery: aaverygonzales
aza.: azaaniah
Joseph Franklin: josephjo.frank
kenady: kenady_cooley
Dani Rose: danimirin11
Iyosias Hailu: iyosiash
Olivia LD: olivia.j.ld
Jillian: jilliantaler
CLAIRE SIRCELY: claire.sircely
Olivia Gerhart: livibeannn
Es: p.esther_1
Lauren Jeanes: lajeanes04
anvith: anvith_reddy666
hannah farris: hannah_farris_
Xiomara: xiomara_rios68
Morgan Marie Hernandez: morgan_m_hernandez
marissa: mariissa.ann
Gini Dyer: ginigdyer
Kyeongseo Choi: 04kyeong
Jordan McAlister: j.mac41
kelly liu: kellyylliu
karla: karla.mew
rebecca: rebecca_oladejo
Yasmin Jenna Jackson: yasmin_jenna_jackson
kennedy renae: kennedyrenae_
madisen lieberman :): madisenkate04
Perise Sasa Siaosi: p.erise
Genna Adelizzi: genna.adelizzi
Katherine: katherinefrazier_
mahek dodani: mahekk.d
isabel redwine: isabel.redwine
Isabela Salazar: salazar.isabela03
Esteban Elias: ea_elias02
Clarissa Carrizo: clarissa_carrizo
Nehir Aran: nehir_aran
lu bierrenbach: luisabierrenbach
Julissa: julissarojass
ania davila: aniadavila
Cristina: cristina__marquez
EMMA GRACE ALVEY: emmalvey
luna: lunareichert_
kendall karoline :): __kdoll__
allison:): x.alli_son.x
Colin Angel: colinjangel
raely fitch :): raely.f
Jay Namdhari: jay.namdhari
miriam zewdu: miriamzewdu
gaby zurita: gaby.zuritaa
Garrett Smith: garrettsmith031
Trent: trent_mosby73
alyssa: al.yssamarie
Will: will_29455
: genevievehendrie
hannah: _hannahcleveland
abi: abigail.jolie
Siena Theivagt: sienatheivagt
kyrielle: kyrielle_1
mike: _michaelsuarez22
luke: lukehweber
Sana Kohli: sanakohli1
Shriya Pendyala: shriyapendyala
Liv: oliviavarcalle
Martin Mulinix: martin_mulinix
Olivia Rocha: oliviarrocha
A.P.: allisonpow3ll
marly shawky: marly.shawky
hannah: hannahtooleyyy
Caleb Geyer: caleb_wisemangeyer
shruthidandamudi: shruthidandamudi
Bella R: isabellaflorencee
maya orenstein: mayaorenstein
Julian Juarez: eltigredelnorte007
Natalia: nataliaia.m
Melissa Donovan Balcom: mdbalcom
Varun Vedala: varun_vedala
Harrison B: harrison_b4
S ¥ D: syd.noelle
Anna:): adobre25
Ericka Dusek: erickadusek
Morgan Davies: morgann.davies
natalia orejas: natiorejas
nicholas: nicholascristan
hadley adams: hadleygadams
Sarri: sarrionna
Monica: monicagarza_3
Reeba Abraham: reebabraham
krissa:): krissajhaveri_
brendan: brendanreynoldss
Argentina Mora <3: morargentina
emily long: emilymiriamlong
Connor Dickson: connor_dickson_
Sarah Shelton: sbshelton04
Jaqueline Del Angel: jackie.da
regina pina <3: regpina21
Brianna Zhang: _briannazhang_
Mikayla M.: itz.lyricxl
Reese: reese_winn
izzy lujan: isabelllalujan
tami adio: tami_adio
Jose Moreno: eljoseamoreno
lili!: lili.toledoo
Andrew Tang: an_drewtang04
Tommy Bannon: thelifeoftommy_21
Bryan Willingham: bryan.willingham
Corinne Piorkowski: ccorinnep
Jose: taco_bell_bong
Sanaa: sanaaalewisss
mihika: mihikapatankar
kourtney miller: kourtneyymiller
nick n: n.ng04
Ellen Sterin: pursefrenzy
kyra: kyra.schobel
mia: miafupetersen
Tori: tori__deawesome
tray: tras0n
emery whitford: emerywhitford
Ethan Fang: efang_12
Steph<3: stephily2
Konghwan Shin: kh_s_ins
Maddie Mandel: maddieemandel
andrea valen(tina): _andreamontenegro
ashley guajardo: ashley.gdo
Vik Gokli: vikgokliii
Tiffany Guerrero: tiffanyreneg
Leah Plowman: leahkplowman
Trinity Brimelow: trinitybrimelow
LiLY WANG: halfhades
Dylan Recker: dylan.recker
Julia Campbell: juliacampbellatx13
Elizabeth Nedley: elnedley
Mina Jeong: _minajeong
Amy Smith Pulliam: amyepulliam
ave;): averyy.raynee
julia quigley: juliaquigleyy
Elizabeth Scott: elizabeth.sscott
Deb Ayres: dayresddsagd
Sabrina Vasquez: sabisvasquez2003
Brock Williams: brockthebeast03
Jasmine: jrmer_25
Jana Madi: janaamadi
felix !: ffelixjegede
Halimot B: halimot_b
: emma.wyattt
Evelyn Sheahan: imevsheahan
mason: mdblalock
¡katie!: katiemfield
ciara <3: offbrandecici
Lilly: lillyredwine
Sofia Elisa Cabello: sofia_cabello3
: marin.holley
Michelle Ogu: officially.michelle
Lillie: lillian.kate
claire: claireschulter
vashed<3: vashedthompson
hope vanderburg: hope.vanderburg
Alessandra Keeler: alessandrakeeler
lauren lindemann: laurenlindemann_
Suzanne Mills Eades: suz.eades
Pau: anapau_gonzalez
Patrick McDonald: pmcdonald_
Lily t: _lily_t_0416
keelin <3: keelin.finley
Aaron Phan: aa.ph4n
annika lærum: annikalaerum
maria de vasconcelos: mariadevas
PAIGE SHIMANSKY: paige.shimansky
Rahul Chalamala: rchalamala
Texas Universities 2026: texasadmits2026
reynuh: reynadews
Tracy Weng: tracyyweng
lia: aliyahbelen
Danelo Ibis Gonzalez III: danelo_g_3
Maya Richards: mayarich03
alyssa lugo: alyssa._lugo
dani: danielamedin.a
isabella vazquez: _isabelllaaaaa_
Salma: sallisal15
gracie lynk: gracie.lynk
emily: _emilyboler_
Katlyn Huynh: katlynhuynhh
Mala Gupta: malagraceg
Luke Miller: lukemlr
Blair Sayers: blairsayers
Abbie Valdez: valdez.abbie
Emma: emmah2022
Maria Tortorelli: maria._trt
Evan Craig: craigohaslosthiseggos
Karyme: karyme.ramireez
lex!: lexjoness_
G: giuseppa.sanfilippo
kirthana: kirthananore
TJ: itstjkohli
Zach Snyder: zachsny26
Kylie Jo: _.kylie_jo._
Phia Parent: phiaparent
keiley tierce: keiley.tierceee
Kristine <3: krissycaridad
Akshay Pradeep: akshaypradeep2004
shelby campbell: shelbyhcampbell
amadee garza: amadeegarza
carolyn hendrix: carolyn_.anne
Gabby Norman: gabby.a.norman
Emma: emmaemigh
: liam.earthman
Ainsley: ainsley_nelli
Angela Tatsch: angela13_764
Stephanie Jumper: stephstephj123
Sydney Jennings: sydneyelisej
maya: mayapai_
Jos: jos._.smith
triniti:): _.trii15._
Rachel Robinson :): rachelrobinson13
Jacob Lee: jaccob_._
Raven T: raven.t08
hannah nixon: hhannahnixonn
Kenneth Garcia: kennethggarcia
Dominique Maldonado: dom_._._marie
Mahdia Rahman: mahdiaaa._
raunak: raunakmanchanda
Bella: a.nicoleplatz
Priscilla Garcia: prixcillagarxia
: l3naaaaaaa
laur :): llllaurenelizabeth
Victoria Lee: victoriatheleek
Katherine :)): katherine_nix
: ximena1809ps
Melani Thapa-Magar: melaannni
N O A: noamoore
Jackson DeBorde: jackson.deborde
casey <3: casey_yoon
kaitlyn marsh :): kaitlynmarshhh
Emily Hill: emilybhilll
Emeka Bielonwu: emeka.03
Briana:): briana._.zuniga
chong :): elaina.chong
marin: marincroix
Bella: bellaboulter
chris lopez: nuychris
Kristal: kristalnicolee_
Mar: maritza.mcneal
Kimberly Culebro: kimberly_culebro
aynoa casavantes: aynoa.c
•jessica jewel tidwell•: jessie.jewel
Jessica Mikell: jessica.mikell
Nathan Zachariah: nathan.zachariah
lauren rivas: laurennrivass
zamira elizabeth: zamiraaae
Elaina Hamuy: elainahamuy
Leland Murphy: lelanddmurphy
Allyson Rodriguez: allyyy_rodd
evan dannenhirsch: evandalize
melanie: melaniebardaless
marcy t.: marcytorrez
ricky: ricardoo.ortiz
: avabarrera
Grant Brewer: gm.brewer
katelyn perryman: katelyn.gp
Cody Hall: codyhalll_
betsy goodrum :): betsygoodrum
A-Y!!: _ahyoungkim
Texas Pi Kappa Alpha Alumni: utaustinpikes
ashley pfeiffer: ashley_pfeiffer23
Maxwell Diamond: maxwell_diamond21
Samantha Dworaczyk: samantha_dworaczyk_
abby kremer: abby.kremer
Camryn: camryn_222
Larson Crank: thelarsoncrank
Abby Grosshandler: abbygrosshandler
Lexi: lexigrace.22
Les: leslyyy_cruzz
Ana Lucia: analuciamtzv
Marely Hernandez: marelyh3
lily: lilycoannn
mimi <3: milicakonatar
austin aguillard: austin2_david
amanda: amandafoy_
: _whoisabella
damaris<3: es_la_dama
mou:p: mouperez13
TyErica Gill: tyericagill
D'Ann Colley: colleypartyof4
Shawn Berger Hickman: shawnybhick
casey knots: casey.knots
lex: alexa_varela
Jorge Rivera: jorgeriveratx
Cyrus Bronson: cyrus_bronson
Mia: mia.latigo
Rodrigo Lopez-Hurtado: rodrigolopezh_
Haylee Bush: haylee_bush_
Madeline Jordan: _madeline_joy
Rea ;): reaganwhitehouse
: gonetotexaswanderer
k r i s: kkristenharris
Alex Scott: aluke.scoot
lucy.: lucyybergerr
Destin Drummond: dezdrummond
: amandaharrelsonn
Kim Simons-Harrison: kimberlharrison
Gabby Aguilar: gabby.aguilarrr
Josh: josh18nieeld
nat: natalielongacre
Sofia Di Salvo: sofia_di.salvo
aidyn neiman: aidynneiman
: dear3mma
Linz: lindsey.hughes
myranda duran <3: luv.randa
talayeh: talayeh.higgs
Hayley Wetzel: hayleywetzel
Audrey Gilbert: audrey.gilby
Mia Spidel: glorriamia
aj gamez <3: aj.gamezz
Kennedi: nolife_ken
Sydney White: sydneydanielle_14
Maddie Paige ™: madell._
Sophia: sophia.3100
Kennedy Bicksler: kennedy_bicksler
Lauren Markwardt: lauren42504
Drift4life16: drift4life16
Ignite Texas: ignitetexas
Bella Gomez: isabellaegomez
christine gerhard: christine_gerhard
Zander: remy_uwu
Libby: libbymtempleton
NEVAEH: nnevaeh.b
Cambrie Priesmeyer: cambriepriesmeyer
Carolynn Brower: carolynnbrower
pri: bittersweet_pri
fernanda herreria: fernandaherreriaa
Jacky Casey: jackycasey
ben goodall: bbengoodall
Abby Daehler: abbydaehler
Lexi Grace: lexi.grace.carpenter
Benn: bennn_ja
Alejandro Banchs: alejandrobanchs
kirsten: kirs.ten909
Brooke Rogers: brookerogers08
Joey Alonzo: joey_a_alonzo
Jayme Thompson: jaymemthompson
Inaki Guerrero: inakigrg
m a r i s a: marisakapavik
tanisha padhi: tanisha_padhi
: ser_mon10
Kiersten: kierstenfinleyy
Lacey Ann Harris: lacey_harris23
averie varnado: averievarnado
Karen Itzel Cazares: karencazares14
Jonathan Herrera: tf6.jona
brooke barron: brookeebarron
mercy.arely.solis: me.ar.so
Brianna Mata: briannaamata_
Jake: jakeblumen
Abigail Quintero: abigaillquintero
AVERY SCHWARTZ: averyschwartzzz
Dayton White: _daytonwhite
mehaa raja amirthalingam: mehaa.raja
lilah bowers: lilahbowers
: k.redrick
Dane: dane11175
Shelbs: shelbyhamburg
Hatscots: hatscots
Martin Rodriguez: martin.rodriguez22
Jerry Rennspies: jerryrennspies
Caden Christian: caden_christian
Shayna Setoudeh-Maram: shaynasetoudeh
Matthew Smith: mmatthewsmith
Kimberly Stern Robertshaw: kimberlybobshaw
emery: emeryjjones
caleb :,): cal.eb24
Anjelina Ortiz: la_anjie
Aubrey ShyAnn Clayton: aubrey.shyann
Kenny Cruz: kenny._.cruzz
Tomas Torres: t0mas_7
harsha: harshakosuri_
katz: katiaa_bc
Katie Walker: katiexwalkerr
Reese Gutshall: reesegutshall
Charlize H. Supapo: csdollahz
Cate: cateadamss
: llaurenpattillo
parmida: parmidakhajeh
tanu tripathi: _tanutripathi_
Allie Gardiner: alliegardiner_
Claudette Lopez: claudette_lopezz
Hailey Anderson: _.hailey__anderson._
Caleb Solorzano: caleb_solorzano
Julia Camacho: _juliacamacho_
Elise Morrissey-Rocha: _elise_autumn_
kennedy: kennedyfoster_
Care: caraalexander_
katherine: katherineethomsonn
Xymena E <3: xymena_escobedo
K E Y R A: smilekeyraaa
catherine: catherinecutbirth
piper: _piper.elizabeth
Patricia: patriciaegarza
isabella rohlik: isabellarohlik
NICOLE KULA: nicolekulaa
Debbie Hedley Jackson: nufcfan1974
Connor Jones: connorchillout
camille: camilleon03
Aprendiz Americano: aprendizamericano
lauren snider: lauren042403
Jackson Roblow: jacksonroblow
: zairakabirr
Isaac Prieto: isaac57894
Grace McGrath: gracekmcgrath
Noble 2500: noble2500apts
britt: brittneyoquinn
spencer: spencercatoire
aiden: aiden.tijerina
caroline cullen: cvroline
Amy: amy_.3707
mads: madison.demauro
madi: madelynjordannn
micah barker: micahbarker_
Will Ramsey: willramsey128
abigail kirkpatrick: abs.kirkpatrick
: thisisjust_an
braeden: braedentidmore
Branton: branton41
chloe: cchloeporras
Tiffany Dinh: tiffanydinh_
Tenley: tenley__claire
Lilia_Oberlin: selena.bartholowmew
Waterloo: waterlooaustin
maggie quinn: maggiequinn_
Matthew Padilla: themattpadilla
Hector Muniz III: hectormunizz
brooke clary: brooke.clary
dayna: dayna.ruizzz
Lauren Yonke: laurenyonke
R Y L I E: rylie.clark
ammad: ammad.hasann
Olivia Kate Ashmore: oliviakashmore
harrison sager: harrison.sagerr
: preston3llis
hayden miller: haydengmiller_
: mae.erinn
Kodi Iden: kodiiden
M I A: miaamatin
Victoria Lopez: victoriaaaaaaaa.1
ashb: ashleytorezzzz
mill ;): milliekralik
Roman Orsini: roman.o
Tawnya Schoech: schoechrules
court: courtneyyconnor_
College Admits + Class of 2026: collegeadmits2026
Maya Walker: mayajwalker
Jocelynn Marissa: jocelynnn__marissa
blake: blakeley.lewis
Lexi Robinson: alexissrobinson
Jerome: jerome_kai11
Grace Goodwin: graceegoodwin
Taylor Walker: taylorwalkeer
: rickbeltrann
A'Jahnay Nayy: nayy_babyyy_
ELISE WEBB: elisewebb
Mason Stanislaus: mason.stanislaus
Nick: nickm.j
Cameron Loyet: camloyet
Sumner Hill: sumner_hill
Legacy on Rio: legacyonrio
Maya: maya.batra
Rowan Brumbaugh: rowanbrum
qing: qingston
Sam Warden: samwardenn
b: brooklin.wagner
Maloree Kuhn: maloreekuhn16_
Kevin Newkirk: kevin_newkirk
: mk_4._
aaron marmolejo: aaron.marmolejoo
Logan Glaser: lglaser796
: ecoffeeluver
Steven Mascolo: steven.mascolo
Daylon Bergeron: daylonbergeron
simri davis: simridavis
Alyssa Osorio: alyssa.anahii
ALANNAH BRUCE: alannahhbruce
PATIO: thepatioapp
Taylor: taytayywalk
Jessica Coley: jessicaacoleyy
Torre | Apartment: torreatx
Juliet Janét: atx.scout.juliet
Domibal: melush0
: nrj820
Jade Sierra: jadesierrra
Ssammmmm K: iissmsaii
Cami: camilegarcia247
Arvis Miller: arvis_miller
: dainaylor
Maatla: kevin_mangwegape
JACKIE PILLOW: jackie_pillow
Latino Studies UT: latinostudiesut
Nathan Howard: nathan_howard24
Soledad Anita Flores: a_need_a_favor
Willy Limy: willylimy
WonderWorld: myxiaoco
: soroity_life
: borred.person
Roppolo’s Pizzeria: roppolos_pizzeria
SKYLOFT ATX: skyloftatx
Aman Aman Aman Aman: amanamanamanaman329
UT Austin | Class of 2025: utfriends25
Bella: isabella._.clover
FrozenRobot: tolathanyou
Nolan Summerhill: nolantheagent
LoopChat: loopchat.app
: victorrodriguez6243
