Filtered Followers:

Erin Sherman: erinsherm11
Heston: hit_man_dios
MK Miller: mkmiller173
Peta Herson Silansky: eventsbypeta
Vivien Perryman: vivien6296747
Betty Black: betty_shellblack
makena: makena.rose.13
Gayla Artman: gjartman
Xavier Kunovich: xavierkunovich
ellie goodno: elliegoodno
Hayden Goodiel: hayden_goodiel_7
Charlie King: charcharistheman
ELLA: ellaacohenn_
Amanda Liese: amanda_liese
The Good Life Park Cities Mag: thegoodlifeparkcitiesmagazine
Kendall Bernbaum: kendallbernbaum
Arman Daddy: armoon_glizzzy
Lindsay Eden Feldman: feldmama
Gray Goldman: gray_goldman
Jo Ann Miller: jo.a.miller.56
suds!!: sutton_rockman
Bella Blackwell: crazybellaboo18
John S. Wilson: stackman14
Teresa Schneider: teresa6565
John_Bulmer: tazmanianwaffle
Elisha Brandenberger: ebrandenberger
Jennifer Harriman: electricangel15
Etan Cohn: etan_cohn
Lara Harrison: larawh
Sulayne Wright: snicklefritz0269
Matthewstrawman: mstrawman55
Levi: levi_gwin
: claudiaqguzman
Caroline Brantman: caroline_and__avellinoz
Heather Schamerloh: hschame
Heather Schwartz Shapan: hshapan
Linda Lipson Pitt Beltzman: unquagirl
Angela Horowitz: angelahorowitz
Ben Gordon: ben.gordon_
Andrea O Norman: andiold
Susan Shosid Bendalin: susanbendi
Sy Black: syblack9678
Kristi Lukeman Owens: kristiowens
Dbiesman: daveybiesman
Karen Riddle Wakefield: karen_wakefield03
Melanie Stegman: melstegman
Mandy Anderson: mandyandy_bu
Carrie Shillingburg: carrie_shillingburg
Gina O'Donnell: ginarothodonnell
Christine Laczai: christinelaczai
Lanier Fisher: lanierfisher
Samantha Janelle: sammyj3320
Amanda Trevino: a.s.t.visual
Lisa Newman: lisa.newman.942
Mando L: mandolopez12345
Jill Allen Schirru: jillschirru
Dede Toothaker Wolf: dorothytwolf
Sam Korman: sam.korman.photos
Jennifer Eckert: turnbunthurman
Blossom Creative School LLC: blossomcreativeschool
Caroline: jcfisch_r
Nikki Durtschi: yellowrosie16
Amanda Ramsey: aramsey04
Karis: karisgross
Christine Schmitz Danuser: christinedanuser
e m m a h u r w i t z: ehurwitz23
Bryan D Bloomfield: _bryandbc01_
Teresa Mantzey: tmantzey
Nudrah Khan: nudrahkhan
Mandy Myers Evans: mandyevans214
Erin Hickman: erinehickman
Karie Hollifield Welsh: karie_welsh5
Jamie Black Standifer: thejamiestandifer
Bryan Buechler: unknownmuffinman
Christine O'Brien Horstman: chris.horstman
Jackson Schneider: jacksonschneider16
Corey Redmond Telschow: crtelschow
Staci Shapiro Rubin: momoffiverubins
Laura Bloom Gordon: lbgordotx
carolinemandel: carolinemandel
Amanda Fair: amandalaurenfair
Dana Rubin: dana.rubin1
Katie Ebner Goodno: lifeisgoodno
Jessica Silverman: jessicasilverman_
: ratalamantez
Adi B3ltzman: adibeltz
Michelle Good Dupré: thedupres99
Eve Myers Herman: eve.herman
Montessori Community School: mcsslc
Jett Harris: 22jettro
Kristin Wertz: kristinwertz
Suzette Switzer: suzetteswitzer
Levi,Richtofen,James D: jamesdavid4095_cosplay
Rachel Hickman: rachel.hickman
Sam Rubin: the_meme_inspector689
: ellie.goodwin
Susan Viracola: sviracola
Brooke Simon Horton: brookeahorton
Beverly Hickman: beverlyhickman
Estela Villasenor: estelawolfe
Schaefer_Terstriep: schaef_67
Julia Rosenblatt: julia_rosenblatt
Joey Newman: covertoperater
Laura Whitfield: laurajeanwhit
Elizabeth Feldman Chapel: elizabethfeldman
Cristy Cobble Brandenburg: cristyb_1
: razaandroth
Good Shepherd Student Ministry: gsstudentmin
Page Fielder: pagefielderrealestate
Rennie Silverman: rensilver
Emily Braden Miller: millergirls
Kristin Schellack Cooper: ks_cooper
amandatracy4: amandatracy4
Joseph Wolf: wolf4624
Sheri Kunovich: sheri.kunovich
Brian Wakefield: wakefieldbrianl
Christina Saczek: christinasaczek
Eve Miller: eve_millerr
Joe Manna: joebananamanna
Molly Schroepfer: mollyschroepfer
Christina Herubin Hernandez: christinaherubin
Julianne Brawner Hoerman: jhoerman
Jennifer Silman Ortiz: jennifer.s.ortiz.7
Bella Blackwell: jesusloverbella
Stevie Hickman: steviedeehickman
Ski le Gap: skilegap
Courtney Miller: courtneygreenmiller
Amanda Nikolopoulos: aspillso
Kevin Boardman: kevinboardman
Kimberly Kahn: kimberly_kahn
Amanda Kerby Portugal: amanda_jayne78
Melissa Harrison: melissaharrisontv
Alexklitsch: alexklitsch
Robin Gordon Sells: robingordonsells
Laura Schroeder: vandelaurt
Stephanie DeLay: stephaniedelay
Harrison. Montgomery: harrison.montgomery
Amy Biesman: abiesman
Walnut Farm Montessori School: walnutfarm_montessori
Hillary Steinberg: hill29_
Sara Golieb: littleteacher1984
Trinity Chandiramani: trinity.c17
Susan Chandler: revsec
Meshea Matthews: sjesdallasheadofschool
BrookeBlackmire: brooke_bm_
Brett Levy: brettandles
Blair Miller: millerslilmonster
Meagan Gordon: gabbie82
Timber_Wolf72: mystictrash72
Sarah Yodh: preschoolpolished
Naman: namanbhushan8
Sara Harris: sara.harris1212
Susan Cooper: scoop19701
Julie Kuntz: jfkuntz
Samantha Hawkins: samholmeshawkins
Debbie Harris: harrisdmh
Christina 'Parker' Rosen: stinaparker
Samantha Mitchell: smitch739
Good Shepherd Episcopal School: gses.dallas
Trinity Chandiramani: trinity.c_17
Mandy Palmer: itsmandypalmer
George Goodno: georgegoodno
Peace Rose Montessori: peacerosemontessori
The St. Anthony School: tsasdfw
Charla Miller: charlamiller__
Megan Schmitt: megskids4
The Fletcher School: fletcherfalcons
Meadowbrook School: meadowbrookschool_dallas
Hannah Wolf: hannahwolfstudios
The Parish School: parishschooltx
Steven Silverman: stevenjay2168
Key School & Key Center: keycenter_fortworth
St. John's Episcopal School: sjesdallas
The Westwood School: westwoodschooldallas
Hessa Abdalrahman: hessa_1st
