Followers:

Emily Lim: emilymlim
Wani Rokar Feeller: waani_rokarfeeller
Shira Makowsky: shira20321
BigSora: reposora
Sean: sean_carey_5
sofia joseph: sofiajosephh_
Sherry Baehr: scoutbear
Matthew Eischen: eischenmatthew
olivia benitez: oliviabenitez_
Stella Frake: stellafrake
tara maiko hagle: taramaiko
Nirali Chandel: nirali_c_
Grace Cherian: grace_cherian_
: keeneh69
Emma Kalchik: emma.kalchik
casey: caseymeskovich
Aziah Kalliduckil: aziahkall15
ryan n: ry_un
lilia: liliadjeddour
Tenzin Nor: norzin1_
Crazyname: crazyname5
alice virani: alice_o325
: retabazi
Paula Jimenez: paulaa_jimenez_
Shaye Palmer: sgt_shaye_p
priscilla ardelean: priscilla_ardelean
Derrick H0: _dellickh_
miles grotto: furntlenom
Maggie Burns: magss.17
Brandon T: _.b.t.__
mariko: mariko.ishiii
Sofia Saldana: sofia.saldana
Giulia: giulia__patrascu
Jack Feldman: jackattack1237
mila mitrovic: milaamitro
david :): davidortinero
SamXD: samxd2025
Connor Kalajdzic: connor_kalajdzic
leo aptekar: leoaptekar_
Lia Christofidis: liachristofidis
Caleb Curescu: calebcurescu
Molly Williams: mollswilliamss
haiyue: haiyueowo
mehreen :): mehrepatel
Irene Metaxas: irene_metaxas5
Elizabeth<3: elizperezzz
Divya Varkey: divy.varkey
Vraj Patel: vrajpat04
Sarah: sarah.bera_
Decklan: decklanbar_04
emily chin: emilyy_chin
Sam Burns: sam_burns_9
Grace Bujdei: gbujdei
BIANCA: biancaa.gabriel
Mahnoor: msl__3604
janine: janinegin16
: hitabharwad
M: michelleherrartee
Lucas Ashorian: lucas.ashorian
Prisha: prisha.s51
Layla Ellis: laylafromthefuture
Leighla Sedghi: leighla_sedghi
NILES WEST ORCHESIS: nileswestorchesis
Anthony Raciti: anthony.raciti
mia k: miakoeberl09
Dia: diapatel04
Nya Lariosa: nya.lariosa20
Samuel Philips: samuelphilips2004
adan: thefakeblondegenovese
humdia ahmad: humdia.a
rumi: rumaisah.h
Tanya: tanya.spasic
Kashish Bastola: kashishbastola
Nikhil Thomas: nikhilthomas310
jessica: jessica.palmer_
abbey: abbeyadams17
Giovanni Galanto: galantogio
murphymaeve :): murphymaeve.holleran
: josip_basan
Versace: versace_man
Jason Schroeder: jason.schroeder14
melanie: melsorisho
ej basha: ej.basha
Tarek Mahfoudi: tarek905
Rainn del Mundo: imake_itrainn
olivia <3: olivia.benyamin
Hana Dautovic: hanadautovic7
Arkady Ayngorn: tatka_ayngorn
Kareem Dibs: kareemdibs
Simon Solano: attackthelight5
Alexia Ardelean: aalexiaardelean
Adhrian: adhri.yo4
sharon: sharonv_12
: juliagonzalez.z
Peter Frake: pfrake4
: markr.04
Jonathan C: chaosxny
: abbyhunt.04
Collin Brooks-Siciliano: brookssiciliano
Ary: aryannawooley
Gabrielle Dela Cruz: gabrielledela0408
Simra: simrashareef
Logan Seplowin: logansep_4
dahlia c: dahliacurescu
Chris Quinn Barnabas: chrisquinnbarnabas
Owais Aslam: _owaisaslam
bailey: baileytheworld
Ben: ben.divovich
Sam Deike: s_a_m_dei_ke
Phil Myco Zulueta: phil_myco_zulueta
Hannah S: zuni_hs
Sami Juma: sami_juma123
Jeremy Molitor: jmolitor10
Rachel Gross: racgro
